- Apple (অ্যাপেল) - আপেল [Noun] I eat an apple. [I-আমি eat-খাই an-একটি apple-আপেল] (আমি একটি আপেল খাই।)
- Ant (অ্যান্ট) - পিঁপড়া [Noun] The ant is small. [The-টি ant-পিঁপড়া is-হয় small-ছোট] (পিঁপড়াটি ছোট।)
- Axe (অ্যাক্স) - কুঠার [Noun] He has an axe. [He-তার has-আছে an-একটি axe-কুঠার] (তার একটি কুঠার আছে।)
- Arm (আর্ম) - বাহু [Noun] My arm is strong. [My-আমার arm-বাহু is-হয় strong-শক্তিশালী] (আমার বাহু শক্তিশালী।)
- Arrow (অ্যারো) - তীর [Noun] The arrow is sharp. [The-টি arrow-তীর is-হয় sharp-ধারালো] (তীরটি ধারালো।)
- Anchor (অ্যাঙ্কর) - নোঙ্গর [Noun] The ship has an anchor. [The-জাহাজটির has-আছে an-একটি anchor-নোঙ্গর] (জাহাজটির একটি নোঙ্গর আছে।)
- Angel (অ্যাঞ্জেল) - দেবদূত [Noun] I saw an angel in my dream. [I-আমি saw-দেখেছি an-একজন angel-দেবদূত in-मध्ये my-আমার dream-স্বপ্নে] (আমি আমার স্বপ্নে একজন দেবদূত দেখেছি।)
- Animal (অ্যানিম্যাল) - পশু [Noun] The lion is a wild animal. [The-টি lion-সিংহ is-হয় a-একটি wild-বন্য animal-পশু] (সিংহ একটি বন্য পশু।)
- Answer (আনসার) - উত্তর [Noun] Give me the answer. [Give-দাও me-আমাকে the-টি answer-উত্তর] (আমাকে উত্তরটি দাও।)
- Apartment (অ্যাপার্টমেন্ট) - অ্যাপার্টমেন্ট [Noun] I live in an apartment. [I-আমি live-থাকি in-এ an-একটি apartment-অ্যাপার্টমেন্টে] (আমি একটি অ্যাপার্টমেন্টে থাকি।)
- Apron (এপ্রোন) - এপ্রোন [Noun] She wears an apron. [She-সে wears-পরে an-একটি apron-এপ্রোন] (সে একটি এপ্রোন পরে।)
- Arch (আর্চ) - খিলান [Noun] The bridge has a beautiful arch. [The-সেতুটির has-আছে a-একটি beautiful-সুন্দর arch-খিলান] (সেতুটির একটি সুন্দর খিলান আছে।)
- Argument (আর্গুমেন্ট) - তর্ক [Noun] They had an argument. [They-তারা had-করেছিল an-একটি argument-তর্ক] (তারা একটি তর্ক করেছিল।)
- Army (আর্মি) - সেনাবাহিনী [Noun] The army protects the country. [The-সেনাবাহিনী army-সেনাবাহিনী protects-রক্ষা করে the-দেশটি country-দেশ] (সেনাবাহিনী দেশটি রক্ষা করে।)
- Artist (আর্টিস্ট) - শিল্পী [Noun] He is a great artist. [He-তিনি is-হন a-একজন great-মহান artist-শিল্পী] (তিনি একজন মহান শিল্পী।)
- Attack (অ্যাটাক) - আক্রমণ [Noun] The army planned an attack. [The-সেনাবাহিনী army-সেনাবাহিনী planned-পরিকল্পনা করেছিল an-একটি attack-আক্রমণের] (সেনাবাহিনী একটি আক্রমণের পরিকল্পনা করেছিল।)
- Aunt (আন্ট) - খালা/চাচি/মাসি/পিসি [Noun] My aunt is coming today. [My-আমার aunt-খালা is-আসছেন coming-আসছেন today-আজ] (আমার খালা আজ আসছেন।)
- Author (অথার) - লেখক [Noun] He is a famous author. [He-তিনি is-হন a-একজন famous-বিখ্যাত author-লেখক] (তিনি একজন বিখ্যাত লেখক।)
- Autumn (অটাম) - শরৎকাল [Noun] The leaves fall in autumn. [The-পাতাগুলো leaves-পাতা fall-ঝরে পড়ে in-এ autumn-শরৎকালে] (শরৎকালে পাতা ঝরে পড়ে।)
- Award (অ্যাওয়ার্ড) - পুরস্কার [Noun] She received an award. [She-সে received-পেয়েছে an-একটি award-পুরস্কার] (সে একটি পুরস্কার পেয়েছে।)
- About (অ্যাবাউট) - সম্পর্কে [Preposition] Tell me about yourself. [Tell-বল me-আমাকে about-সম্পর্কে yourself-তোমার নিজের] (তোমার নিজের সম্পর্কে আমাকে বল।)
- Above (অ্যাবাভ) - উপরে [Preposition] The sky is above us. [The-আকাশ sky-আকাশ is-আছে above-উপরে us-আমাদের] (আকাশ আমাদের উপরে আছে।)
- Across (অ্যাক্রস) - জুড়ে [Preposition] He walked across the road. [He-সে walked-হেঁটেছিল across-জুড়ে the-রাস্তাটি road-রাস্তা] (সে রাস্তাটি জুড়ে হেঁটেছিল।)
- Act (অ্যাক্ট) - অভিনয় করা [Verb] She can act very well. [She-সে can-পারে act-অভিনয় করতে very-খুব well-ভালো] (সে খুব ভালো অভিনয় করতে পারে।)
- Add (অ্যাড) - যোগ করা [Verb] Please add some sugar. [Please-দয়া করে add-যোগ করুন some-কিছু sugar-চিনি] (দয়া করে কিছু চিনি যোগ করুন।)
- Admire (অ্যাডমায়ার) - প্রশংসা করা [Verb] I admire your courage. [I-আমি admire-প্রশংসা করি your-তোমার courage-সাহসের] (আমি তোমার সাহসের প্রশংসা করি।)
- Admit (অ্যাডমিট) - স্বীকার করা [Verb] He admitted his mistake. [He-সে admitted-স্বীকার করেছে his-তার mistake-ভুল] (সে তার ভুল স্বীকার করেছে।)
- Advise (অ্যাডভাইস) - উপদেশ দেওয়া [Verb] The doctor advised him to rest. [The-ডাক্তার doctor-ডাক্তার advised-উপদেশ দিয়েছেন him-তাকে to-জন্য rest-বিশ্রামের] (ডাক্তার তাকে বিশ্রামের জন্য উপদেশ দিয়েছেন।)
- Agree (এগ্রি) - রাজি হওয়া [Verb] I agree with you. [I-আমি agree-রাজি with-সাথে you-তোমার] (আমি তোমার সাথে রাজি।)
- Aim (এইম) - লক্ষ্য করা [Verb] He aimed at the target. [He-সে aimed-লক্ষ্য করেছিল at-দিকে the-লক্ষ্যবস্তুটির target-লক্ষ্যবস্তু] (সে লক্ষ্যবস্তুটির দিকে লক্ষ্য করেছিল।)
- Allow (অ্যালাউ) - অনুমতি দেওয়া [Verb] My parents allowed me to go. [My-আমার parents-বাবা-মা allowed-অনুমতি দিয়েছে me-আমাকে to-জন্য go-যাওয়ার] (আমার বাবা-মা আমাকে যাওয়ার জন্য অনুমতি দিয়েছে।)
- Announce (অ্যানাউন্স) - ঘোষণা করা [Verb] The principal will announce the results. [The-অধ্যক্ষ principal-অধ্যক্ষ will-করবেন announce-ঘোষণা the-ফলাফল results-ফলাফল] (অধ্যক্ষ ফলাফল ঘোষণা করবেন।)
- Appear (অ্যাপিয়ার) - উপস্থিত হওয়া [Verb] A star appeared in the sky. [A-একটি star-তারা appeared-উপস্থিত হল in-এ the-আকাশে sky-আকাশ] (আকাশে একটি তারা উপস্থিত হল।)
- Apply (অ্যাপ্লাই) - আবেদন করা [Verb] I will apply for the job. [I-আমি will-করব apply-আবেদন for-জন্য the-চাকরিটির job-চাকরি] (আমি চাকরিটির জন্য আবেদন করব।)
- Argue (আর্গিউ) - তর্ক করা [Verb] Don't argue with me. [Don't-করো না argue-তর্ক with-সাথে me-আমার] (আমার সাথে তর্ক করো না।)
- Arrange (অ্যারেঞ্জ) - ব্যবস্থা করা [Verb] Please arrange a meeting. [Please-দয়া করে arrange-ব্যবস্থা করুন a-একটি meeting-সভার] (দয়া করে একটি সভার ব্যবস্থা করুন।)
- Arrest (অ্যারেস্ট) - গ্রেপ্তার করা [Verb] The police arrested the thief. [The-পুলিশ police-পুলিশ arrested-গ্রেপ্তার করেছে the-চোরটিকে thief-চোর] (পুলিশ চোরটিকে গ্রেপ্তার করেছে।)
- Arrive (অ্যারাইভ) - পৌঁছানো [Verb] The train will arrive soon. [The-ট্রেনটি train-ট্রেন will-পৌঁছাবে arrive-পৌঁছাবে soon-শীঘ্রই] (ট্রেনটি শীঘ্রই পৌঁছাবে।)
- Ask (আস্ক) - জিজ্ঞাসা করা [Verb] Ask me a question. [Ask-জিজ্ঞাসা কর me-আমাকে a-একটি question-প্রশ্ন] (আমাকে একটি প্রশ্ন জিজ্ঞাসা কর।)
- Attach (অ্যাটাচ) - সংযুক্ত করা [Verb] Please attach the file. [Please-দয়া করে attach-সংযুক্ত করুন the-ফাইলটি file-ফাইল] (দয়া করে ফাইলটি সংযুক্ত করুন।)
- Attempt (অ্যাটেম্পট) - চেষ্টা করা [Verb] He will attempt to climb the mountain. [He-সে will-করবে attempt-চেষ্টা to-জন্য climb-আরোহণের the-পাহাড়টি mountain-পাহাড়] (সে পাহাড়টি আরোহণের জন্য চেষ্টা করবে।)
- Attend (অ্যাটেন্ড) - উপস্থিত থাকা [Verb] I will attend the party. [I-আমি will-থাকব attend-উপস্থিত the-পার্টিতে party-পার্টি] (আমি পার্টিতে উপস্থিত থাকব।)
- Attract (অ্যাট্রাক্ট) - আকর্ষণ করা [Verb] The magnet attracts iron. [The-চুম্বক magnet-চুম্বক attracts-আকর্ষণ করে iron-লোহা] (চুম্বক লোহা আকর্ষণ করে।)
- Avoid (অ্যাভয়েড) - এড়িয়ে চলা [Verb] You should avoid bad company. [You-তোমার should-উচিত avoid-এড়িয়ে চলা bad-খারাপ company-সঙ্গ] (তোমার খারাপ সঙ্গ এড়িয়ে চলা উচিত।)
- Awake (অ্যাওয়েক) - জেগে থাকা [Adjective] I am wide awake. [I-আমি am-আছি wide-সম্পূর্ণ awake-জেগে] (আমি সম্পূর্ণ জেগে আছি।)
- Aware (অ্যাওয়ার) - সচেতন [Adjective] Be aware of the danger. [Be-থাকুন aware-সচেতন of-সম্পর্কে the-বিপদটির danger-বিপদ] (বিপদটি সম্পর্কে সচেতন থাকুন।)
- Awful (অফুল) - ভয়ানক [Adjective] The weather is awful. [The-আবহাওয়া weather-আবহাওয়া is-হয় awful-ভয়ানক] (আবহাওয়া ভয়ানক।)
- Able (এবল) - সক্ষম [Adjective] You are able to do it. [You-তুমি are-হও able-সক্ষম to-করতে do-করতে it-এটা] (তুমি এটা করতে সক্ষম।)
- Absent (অ্যাবসেন্ট) - অনুপস্থিত [Adjective] He was absent yesterday. [He-সে was-ছিল absent-অনুপস্থিত yesterday-গতকাল] (সে গতকাল অনুপস্থিত ছিল।)
- Absolute (অ্যাবসলিউট) - পরম [Adjective] It is the absolute truth. [It-এটা is-হয় the-পরম absolute-পরম truth-সত্য] (এটা পরম সত্য।)
- Academic (অ্যাকাডেমিক) - শিক্ষাগত [Adjective] He has a strong academic background. [He-তার has-আছে a-একটি strong-শক্তিশালী academic-শিক্ষাগত background-পটভূমি] (তার একটি শক্তিশালী শিক্ষাগত পটভূমি আছে।)
- Acceptable (অ্যাক্সেপ্টেবল) - গ্রহণযোগ্য [Adjective] Your proposal is acceptable. [Your-তোমার proposal-প্রস্তাব is-হয় acceptable-গ্রহণযোগ্য] (তোমার প্রস্তাব গ্রহণযোগ্য।)
- Accurate (অ্যাকিউরেট) - সঠিক [Adjective] The report is accurate. [The-প্রতিবেদনটি report-প্রতিবেদন is-হয় accurate-সঠিক] (প্রতিবেদনটি সঠিক।)
- Active (অ্যাক্টিভ) - সক্রিয় [Adjective] He is an active person. [He-তিনি is-হন an-একজন active-সক্রিয় person-ব্যক্তি] (তিনি একজন সক্রিয় ব্যক্তি।)
- Actual (অ্যাকচুয়াল) - প্রকৃত [Adjective] What is the actual price? [What-কি is-হয় the-প্রকৃত actual-প্রকৃত price-দাম] (প্রকৃত দাম কি?)
- Additional (অ্যাডিশনাল) - অতিরিক্ত [Adjective] We need additional information. [We-আমাদের need-দরকার additional-অতিরিক্ত information-তথ্য] (আমাদের অতিরিক্ত তথ্য দরকার।)
- Adequate (অ্যাডিকেট) - পর্যাপ্ত [Adjective] We have adequate food. [We-আমাদের have-আছে adequate-পর্যাপ্ত food-খাবার] (আমাদের পর্যাপ্ত খাবার আছে।)
- Administrative (অ্যাডমিনিস্ট্রেটিভ) - প্রশাসনিক [Adjective] He works in the administrative department. [He-তিনি works-কাজ করেন in-এ the-প্রশাসনিক administrative-প্রশাসনিক department-বিভাগে] (তিনি প্রশাসনিক বিভাগে কাজ করেন।)
- Adult (অ্যাডাল্ট) - প্রাপ্তবয়স্ক [Adjective] This movie is for adults only. [This-এই movie-চলচ্চিত্রটি is-হয় for-জন্য adults-প্রাপ্তবয়স্কদের only-শুধুমাত্র] (এই চলচ্চিত্রটি শুধুমাত্র প্রাপ্তবয়স্কদের জন্য।)
- Advanced (অ্যাডভান্সড) - উন্নত [Adjective] This is an advanced course. [This-এটা is-হয় an-একটি advanced-উন্নত course-কোর্স] (এটা একটি উন্নত কোর্স।)
- Afraid (অ্যাফ্রেইড) - ভীত [Adjective] Don't be afraid. [Don't-হয়ো না be-হয়ো afraid-ভীত] (ভীত হয়ো না।)
- Afternoon (আফটারনুন) - বিকেল [Noun] I will meet you in the afternoon. [I-আমি will-করব meet-দেখা you-তোমার সাথে in-এ the-বিকেলে afternoon-বিকেল] (আমি তোমার সাথে বিকেলে দেখা করব।)
- Again (অ্যাগেইন) - আবার [Adverb] Say it again. [Say-বল it-এটা again-আবার] (এটা আবার বল।)
- Age (এইজ) - বয়স [Noun] What is your age? [What-কি is-হয় your-তোমার age-বয়স] (তোমার বয়স কত?)
- Agency (এজেন্সি) - সংস্থা [Noun] He works for a travel agency. [He-সে works-কাজ করে for-জন্য a-একটি travel-ভ্রমণ agency-সংস্থায়] (সে একটি ভ্রমণ সংস্থায় কাজ করে।)
- Agenda (এজেন্ডা) - আলোচ্যসূচি [Noun] What is on the agenda today? [What-কি is-আছে on-উপর the-আলোচ্যসূচিতে agenda-আলোচ্যসূচি today-আজ] (আজ আলোচ্যসূচিতে কি আছে?)
- Agent (এজেন্ট) - প্রতিনিধি [Noun] He is a secret agent. [He-সে is-হয় a-একজন secret-গোপন agent-প্রতিনিধি] (সে একজন গোপন প্রতিনিধি।)
- Ago (এগো) - আগে [Adverb] I met him a long time ago. [I-আমি met-দেখা করেছিলাম him-তার সাথে a-অনেক long-অনেক time-সময় ago-আগে] (আমি তার সাথে অনেক সময় আগে দেখা করেছিলাম।)
- Agreement (এগ্রিমেন্ট) - চুক্তি [Noun] We have an agreement. [We-আমাদের have-আছে an-একটি agreement-চুক্তি] (আমাদের একটি চুক্তি আছে।)
- Ahead (এহেড) - সামনে [Adverb] Go ahead. [Go-যাও ahead-সামনে] (সামনে যাও।)
- Aid (এইড) - সাহায্য [Noun] They need medical aid. [They-তাদের need-দরকার medical-চিকিৎসা aid-সাহায্য] (তাদের চিকিৎসা সাহায্য দরকার।)
- Air (এয়ার) - বাতাস [Noun] We need fresh air. [We-আমাদের need-দরকার fresh-বিশুদ্ধ air-বাতাস] (আমাদের বিশুদ্ধ বাতাস দরকার।)
- Aircraft (এয়ারক্রাফট) - বিমান [Noun] The aircraft is ready for takeoff. [The-বিমানটি aircraft-বিমান is-হয় ready-প্রস্তুত for-জন্য takeoff-উড্ডয়নের] (বিমানটি উড্ডয়নের জন্য প্রস্তুত।)
- Airline (এয়ারলাইন) - বিমান সংস্থা [Noun] Which airline are you flying with? [Which-কোন airline-বিমান সংস্থায় are-তুমি you-তুমি flying-যাচ্ছ with-সাথে] (তুমি কোন বিমান সংস্থায় যাচ্ছ?)
- Airport (এয়ারপোর্ট) - বিমানবন্দর [Noun] I am at the airport. [I-আমি am-আছি at-এ the-বিমানবন্দরে airport-বিমানবন্দর] (আমি বিমানবন্দরে আছি।)
- Alarm (অ্যালার্ম) - বিপদ সংকেত [Noun] The fire alarm went off. [The-আগুনের fire-আগুন alarm-বিপদ সংকেত went-বেজে উঠল off-বন্ধ] (আগুনের বিপদ সংকেত বেজে উঠল।)
- Album (অ্যালবাম) - অ্যালবাম [Noun] I have a photo album. [I-আমার have-আছে a-একটি photo-ছবির album-অ্যালবাম] (আমার একটি ছবির অ্যালবাম আছে।)
- Alcohol (অ্যালকোহল) - মদ [Noun] He does not drink alcohol. [He-সে does-করে না not-না drink-পান alcohol-মদ] (সে মদ পান করে না।)
- Alike (অ্যালাইক) - একই রকম [Adjective] The two brothers look alike. [The-দুই the two-দুই brothers-ভাই look-দেখতে alike-একই রকম] (দুই ভাই দেখতে একই রকম।)
- Alive (অ্যালাইভ) - জীবিত [Adjective] He is still alive. [He-সে is-হয় still-এখনও alive-জীবিত] (সে এখনও জীবিত।)
- All (অল) - সব [Determiner] All students are present. [All-সব students-ছাত্রছাত্রীরা are-হয় present-উপস্থিত] (সব ছাত্রছাত্রীরা উপস্থিত।)
- Alliance (অ্যালায়েন্স) - জোট [Noun] They formed an alliance. [They-তারা formed-গঠন করেছে an-একটি alliance-জোট] (তারা একটি জোট গঠন করেছে।)
- Almost (অলমোস্ট) - প্রায় [Adverb] I am almost done. [I-আমি am-হয় almost-প্রায় done-শেষ] (আমার প্রায় শেষ।)
- Alone (অ্যালোন) - একা [Adjective] I want to be alone. [I-আমি want-চাই to-থাকতে be-থাকতে alone-একা] (আমি একা থাকতে চাই।)
- Along (অ্যালং) - বরাবর [Preposition] We walked along the river. [We-আমরা walked-হেঁটেছিলাম along-বরাবর the-নদীটির river-নদী] (আমরা নদীটি বরাবর হেঁটেছিলাম।)
- Already (অলরেডি) - ইতিমধ্যে [Adverb] I have already finished my work. [I-আমি have-করেছি already-ইতিমধ্যে finished-শেষ my-আমার work-কাজ] (আমি ইতিমধ্যে আমার কাজ শেষ করেছি।)
- Also (অলসো) - এছাড়াও [Adverb] I like tea, and I also like coffee. [I-আমি like-পছন্দ করি tea-চা, and-এবং I-আমি also-এছাড়াও like-পছন্দ করি coffee-কফি] (আমি চা পছন্দ করি, এবং এছাড়াও আমি কফি পছন্দ করি।)
- Alternative (অল্টারনেটিভ) - বিকল্প [Noun] Is there any alternative? [Is-আছে there-সেখানে any-কোন alternative-বিকল্প] (সেখানে কি কোন বিকল্প আছে?)
- Although (অলদো) - যদিও [Conjunction] Although it was raining, he went out. [Although-যদিও it-এটা was-ছিল raining-বৃষ্টি হচ্ছিল, he-সে went-গিয়েছিল out-বাইরে] (যদিও বৃষ্টি হচ্ছিল, সে বাইরে গিয়েছিল।)
- Always (অলওয়েজ) - সর্বদা [Adverb] I will always love you. [I-আমি will-করব always-সর্বদা love-ভালোবাসা you-তোমাকে] (আমি তোমাকে সর্বদা ভালোবাসব।)
- Amazing (অ্যামেজিং) - আশ্চর্যজনক [Adjective] The view is amazing. [The-দৃশ্যটি view-দৃশ্য is-হয় amazing-আশ্চর্যজনক] (দৃশ্যটি আশ্চর্যজনক।)
- Ambition (অ্যাম্বিশন) - উচ্চাকাঙ্ক্ষা [Noun] My ambition is to be a doctor. [My-আমার ambition-উচ্চাকাঙ্ক্ষা is-হয় to-হওয়া be-হওয়া a-একজন doctor-ডাক্তার] (আমার উচ্চাকাঙ্ক্ষা হল একজন ডাক্তার হওয়া।)
- Ambulance (অ্যাম্বুলেন্স) - অ্যাম্বুলেন্স [Noun] Call an ambulance quickly. [Call-ডাকুন an-একটি ambulance-অ্যাম্বুলেন্স quickly-তাড়াতাড়ি] (তাড়াতাড়ি একটি অ্যাম্বুলেন্স ডাকুন।)
- Among (অ্যামাং) - মধ্যে [Preposition] The house is among the trees. [The-বাড়িটি house-বাড়ি is-হয় among-মধ্যে the-গাছগুলোর trees-গাছ] (বাড়িটি গাছগুলোর মধ্যে।)
- Amount (অ্যামাউন্ট) - পরিমাণ [Noun] What is the total amount? [What-কত is-হয় the-মোট total-মোট amount-পরিমাণ] (মোট পরিমাণ কত?)
- Analysis (অ্যানালিসিস) - বিশ্লেষণ [Noun] The analysis of the data is complete. [The-বিশ্লেষণ analysis-বিশ্লেষণ of-এর the-ডেটার data-ডেটা is-হয় complete-সম্পূর্ণ] (ডেটার বিশ্লেষণ সম্পূর্ণ।)
- Ancient (এনশিয়েন্ট) - প্রাচীন [Adjective] This is an ancient temple. [This-এটা is-হয় an-একটি ancient-প্রাচীন temple-মন্দির] (এটা একটি প্রাচীন মন্দির।)
- And (অ্যান্ড) - এবং [Conjunction] I like tea and coffee. [I-আমি like-পছন্দ করি tea-চা and-এবং coffee-কফি] (আমি চা এবং কফি পছন্দ করি।)
- Anger (অ্যাঙ্গার) - রাগ [Noun] He is full of anger. [He-সে is-হয় full-পূর্ণ of-এ anger-রাগে] (সে রাগে পূর্ণ।)
- Angle (অ্যাঙ্গেল) - কোণ [Noun] A triangle has three angles. [A-একটি triangle-ত্রিভুজের has-আছে three-তিনটি angles-কোণ] (একটি ত্রিভুজের তিনটি কোণ আছে।)
- Angry (অ্যাংরি) - রাগান্বিত [Adjective] Are you angry with me? [Are-তুমি কি you-তুমি angry-রাগান্বিত with-সাথে me-আমার] (তুমি কি আমার সাথে রাগান্বিত?)
- Anniversary (অ্যানিভার্সারি) - বার্ষিকী [Noun] Today is our wedding anniversary. [Today-আজ is-হয় our-আমাদের wedding-বিবাহ anniversary-বার্ষিকী] (আজ আমাদের বিবাহ বার্ষিকী।)
- Annoy (অ্যানয়) - বিরক্ত করা [Verb] Don't annoy me. [Don't-করো না annoy-বিরক্ত me-আমাকে] (আমাকে বিরক্ত করো না।)
- Annual (অ্যানুয়াল) - বার্ষিক [Adjective] This is an annual event. [This-এটা is-হয় an-একটি annual-বার্ষিক event-অনুষ্ঠান] (এটা একটি বার্ষিক অনুষ্ঠান।)
- Another (অ্যানাদার) - অন্য [Determiner] Can I have another cup of tea? [Can-পারি I-আমি have-নিতে another-অন্য cup-কাপ of-এর tea-চা] (আমি কি আর এক কাপ চা নিতে পারি?)
- Anxious (অ্যাংশাস) - উদ্বিগ্ন [Adjective] I am anxious about the exam. [I-আমি am-আছি anxious-উদ্বিগ্ন about-নিয়ে the-পরীক্ষাটি exam-পরীক্ষা] (আমি পরীক্ষাটি নিয়ে উদ্বিগ্ন।)
- Any (এনি) - কোন [Determiner] Do you have any questions? [Do-তোমার কি you-তোমার have-আছে any-কোন questions-প্রশ্ন] (তোমার কি কোন প্রশ্ন আছে?)
- Anybody (এনিবডি) - যে কেউ [Pronoun] Can anybody solve this problem? [Can-পারে anybody-যে কেউ solve-সমাধান করতে this-এই problem-সমস্যাটি] (যে কেউ কি এই সমস্যাটি সমাধান করতে পারে?)
- Anymore (এনিমোর) - আর [Adverb] I don't live there anymore. [I-আমি don't-থাকি না live-থাকি there-সেখানে anymore-আর] (আমি আর সেখানে থাকি না।)
- Anyone (এনিওয়ান) - যে কেউ [Pronoun] Anyone can do it. [Anyone-যে কেউ can-পারে do-করতে it-এটা] (যে কেউ এটা করতে পারে।)
- Anything (এনিথিং) - কিছু [Pronoun] Do you want anything? [Do-তোমার কি you-তোমার want-চাই anything-কিছু] (তোমার কি কিছু চাই?)
- Anyway (এনিওয়ে) - যাইহোক [Adverb] Anyway, let's start. [Anyway-যাইহোক, let's-চলুন start-শুরু করি] (যাইহোক, চলুন শুরু করি।)
- Anywhere (এনিহোয়্যার) - যে কোন জায়গায় [Adverb] You can go anywhere you want. [You-তুমি can-পারো go-যেতে anywhere-যে কোন জায়গায় you-তুমি want-চাও] (তুমি যেখানে চাও যেতে পারো।)
- Apart (অ্যাপার্ট) - আলাদা [Adverb] They live apart. [They-তারা live-থাকে apart-আলাদা] (তারা আলাদা থাকে।)
- Apologize (অ্যাপোলোজাইজ) - ক্ষমা চাওয়া [Verb] You should apologize to him. [You-তোমার should-উচিত apologize-ক্ষমা চাওয়া to-কাছে him-তার] (তোমার তার কাছে ক্ষমা চাওয়া উচিত।)
- Apparent (অ্যাপারেন্ট) - স্পষ্ট [Adjective] The reason is apparent. [The-কারণটি reason-কারণ is-হয় apparent-স্পষ্ট] (কারণটি স্পষ্ট।)
- Appeal (আপিল) - আবেদন [Noun] He made an appeal for help. [He-সে made-করেছিল an-একটি appeal-আবেদন for-জন্য help-সাহায্যের] (সে সাহায্যের জন্য একটি আবেদন করেছিল।)
- Appearance (অ্যাপিয়ারেন্স) - চেহারা [Noun] He has a friendly appearance. [He-তার has-আছে a-একটি friendly-বন্ধুত্বপূর্ণ appearance-চেহারা] (তার একটি বন্ধুত্বপূর্ণ চেহারা আছে।)
- Application (অ্যাপ্লিকেশন) - আবেদনপত্র [Noun] I have submitted my application. [I-আমি have-জমা দিয়েছি submitted-জমা দিয়েছি my-আমার application-আবেদনপত্র] (আমি আমার আবেদনপত্র জমা দিয়েছি।)
- Appoint (অ্যাপয়েন্ট) - নিয়োগ করা [Verb] He was appointed as the new manager. [He-তাকে was-করা হয়েছিল appointed-নিয়োগ as-হিসাবে the-নতুন new-নতুন manager-ম্যানেজার] (তাকে নতুন ম্যানেজার হিসাবে নিয়োগ করা হয়েছিল।)
- Appointment (অ্যাপয়েন্টমেন্ট) - সাক্ষাৎ [Noun] I have an appointment with the doctor. [I-আমার have-আছে an-একটি appointment-সাক্ষাৎ with-সাথে the-ডাক্তারের doctor-ডাক্তার] (আমার ডাক্তারের সাথে একটি সাক্ষাৎ আছে।)
- Appreciate (অ্যাপ্রিশিয়েট) - প্রশংসা করা [Verb] I appreciate your help. [I-আমি appreciate-প্রশংসা করি your-তোমার help-সাহায্যের] (আমি তোমার সাহায্যের প্রশংসা করি।)
- Approach (অ্যাপ্রোচ) - কাছে আসা [Verb] The cat is approaching the mouse. [The-বিড়ালটি cat-বিড়াল is-আসছে approaching-কাছে the-ইঁদুরটির mouse-ইঁদুর] (বিড়ালটি ইঁদুরটির কাছে আসছে।)
- Appropriate (অ্যাপ্রোপ্রিয়েট) - উপযুক্ত [Adjective] This is not the appropriate time. [This-এটা is-নয় not-নয় the-উপযুক্ত appropriate-উপযুক্ত time-সময়] (এটা উপযুক্ত সময় নয়।)
- Approval (অ্যাপ্রুভাল) - অনুমোদন [Noun] I need your approval. [I-আমার need-দরকার your-তোমার approval-অনুমোদন] (আমার তোমার অনুমোদন দরকার।)
- Approve (অ্যাপ্রুভ) - অনুমোদন করা [Verb] The manager approved my leave. [The-ম্যানেজার manager-ম্যানেজার approved-অনুমোদন করেছে my-আমার leave-ছুটি] (ম্যানেজার আমার ছুটি অনুমোদন করেছে।)
- Approximately (অ্যাপ্রক্সিমেটলি) - প্রায় [Adverb] It will take approximately one hour. [It-এটা will-লাগবে take-লাগবে approximately-প্রায় one-এক hour-ঘন্টা] (এটা প্রায় এক ঘন্টা লাগবে।)
- April (এপ্রিল) - এপ্রিল [Noun] My birthday is in April. [My-আমার birthday-জন্মদিন is-হয় in-এ April-এপ্রিলে] (আমার জন্মদিন এপ্রিলে।)
- Area (এরিয়া) - এলাকা [Noun] This is a residential area. [This-এটা is-হয় a-একটি residential-আবাসিক area-এলাকা] (এটা একটি আবাসিক এলাকা।)
- Armchair (আর্মচেয়ার) - আরামকেদারা [Noun] He is sitting in an armchair. [He-সে is-বসে আছে sitting-বসে আছে in-এ an-একটি armchair-আরামকেদারায়] (সে একটি আরামকেদারায় বসে আছে।)
- Around (অ্যারাউন্ড) - চারপাশে [Preposition] We sat around the table. [We-আমরা sat-বসেছিলাম around-চারপাশে the-টেবিলটির table-টেবিল] (আমরা টেবিলটির চারপাশে বসেছিলাম।)
- Arrival (অ্যারাইভাল) - আগমন [Noun] The arrival of the train was delayed. [The-আগমন arrival-আগমন of-এর the-ট্রেনটির train-ট্রেন was-ছিল delayed-বিলম্বিত] (ট্রেনটির আগমন বিলম্বিত ছিল।)
- Article (আর্টিকেল) - প্রবন্ধ [Noun] I read an interesting article. [I-আমি read-পড়েছি an-একটি interesting-আকর্ষণীয় article-প্রবন্ধ] (আমি একটি আকর্ষণীয় প্রবন্ধ পড়েছি।)
- Aside (অ্যাসাইড) - একপাশে [Adverb] Step aside, please. [Step-সরুন aside-একপাশে, please-দয়া করে] (দয়া করে একপাশে সরুন।)
- Asleep (অ্যাস্লিপ) - ঘুমন্ত [Adjective] The baby is asleep. [The-শিশুটা baby-শিশু is-হয় asleep-ঘুমন্ত] (শিশুটা ঘুমন্ত।)
- Aspect (অ্যাসপেক্ট) - দিক [Noun] We should consider all aspects. [We-আমাদের should-উচিত consider-বিবেচনা করা all-সব aspects-দিক] (আমাদের সব দিক বিবেচনা করা উচিত।)
- Assemble (অ্যাসেম্বল) - একত্রিত করা [Verb] We will assemble in the hall. [We-আমরা will-হব assemble-একত্রিত in-এ the-হলে hall-হল] (আমরা হলে একত্রিত হব।)
- Assess (অ্যাসেস) - মূল্যায়ন করা [Verb] We need to assess the situation. [We-আমাদের need-দরকার to-করতে assess-মূল্যায়ন the-পরিস্থিতিটি situation-পরিস্থিতি] (আমাদের পরিস্থিতিটি মূল্যায়ন করতে হবে।)
- Assessment (অ্যাসেসমেন্ট) - মূল্যায়ন [Noun] The assessment will be done tomorrow. [The-মূল্যায়ন assessment-মূল্যায়ন will-হবে be-হবে done-করা tomorrow-আগামীকাল] (মূল্যায়ন আগামীকাল করা হবে।)
- Asset (অ্যাসেট) - সম্পদ [Noun] Health is a great asset. [Health-স্বাস্থ্য is-হয় a-একটি great-বড় asset-সম্পদ] (স্বাস্থ্য একটি বড় সম্পদ।)
- Assign (অ্যাসাইন) - বরাদ্দ করা [Verb] The teacher assigned us homework. [The-শিক্ষক teacher-শিক্ষক assigned-বরাদ্দ করেছেন us-আমাদের homework-বাড়ির কাজ] (শিক্ষক আমাদের বাড়ির কাজ বরাদ্দ করেছেন।)
- Assignment (অ্যাসাইনমেন্ট) - নির্ধারিত কাজ [Noun] I have to finish my assignment. [I-আমাকে have-করতে হবে to-করতে finish-শেষ my-আমার assignment-নির্ধারিত কাজ] (আমাকে আমার নির্ধারিত কাজ শেষ করতে হবে।)
- Assist (অ্যাসিস্ট) - সাহায্য করা [Verb] Can I assist you? [Can-পারি I-আমি assist-সাহায্য করতে you-আপনাকে] (আমি কি আপনাকে সাহায্য করতে পারি?)
- Assistance (অ্যাসিস্ট্যান্স) - সাহায্য [Noun] I need your assistance. [I-আমার need-দরকার your-আপনার assistance-সাহায্য] (আমার আপনার সাহায্য দরকার।)
- Assistant (অ্যাসিস্ট্যান্ট) - সহকারী [Noun] He is my assistant. [He-সে is-হয় my-আমার assistant-সহকারী] (সে আমার সহকারী।)
- Associate (অ্যাসোসিয়েট) - সহযোগী [Noun] He is a business associate. [He-তিনি is-হন a-একজন business-ব্যবসায়িক associate-সহযোগী] (তিনি একজন ব্যবসায়িক সহযোগী।)
- Association (অ্যাসোসিয়েশন) - সমিতি [Noun] I am a member of this association. [I-আমি am-হই a-একজন member-সদস্য of-এর this-এই association-সমিতির] (আমি এই সমিতির একজন সদস্য।)
- Assume (অ্যাসিউম) - অনুমান করা [Verb] I assume you are right. [I-আমি assume-অনুমান করি you-তুমি are-হও right-সঠিক] (আমি অনুমান করি তুমি সঠিক।)
- Assumption (অ্যাসাম্পশন) - অনুমান [Noun] Your assumption is wrong. [Your-তোমার assumption-অনুমান is-হয় wrong-ভুল] (তোমার অনুমান ভুল।)
- Assure (অ্যাশিওর) - আশ্বাস দেওয়া [Verb] I assure you that everything will be fine. [I-আমি assure-আশ্বাস দিচ্ছি you-তোমাকে that-যে everything-সবকিছু will-হবে be-হবে fine-ঠিক] (আমি তোমাকে আশ্বাস দিচ্ছি যে সবকিছু ঠিক হবে।)
- Atmosphere (অ্যাটমোস্ফিয়ার) - বায়ুমণ্ডল [Noun] The atmosphere of the Earth is very important. [The-বায়ুমণ্ডল atmosphere-বায়ুমণ্ডল of-এর the-পৃথিবীর Earth-পৃথিবী is-হয় very-খুব important-গুরুত্বপূর্ণ] (পৃথিবীর বায়ুমণ্ডল খুব গুরুত্বপূর্ণ।)
- Attachment (অ্যাটাচমেন্ট) - সংযুক্তি [Noun] Please find the attachment. [Please-দয়া করে find-খুঁজুন the-সংযুক্তিটি attachment-সংযুক্তি] (দয়া করে সংযুক্তিটি খুঁজুন।)
- Attitude (অ্যাটিটিউড) - মনোভাব [Noun] He has a positive attitude. [He-তার has-আছে a-একটি positive-ইতিবাচক attitude-মনোভাব] (তার একটি ইতিবাচক মনোভাব আছে।)
- Attorney (অ্যাটর্নি) - আইনজীবী [Noun] I need to talk to my attorney. [I-আমাকে need-দরকার to-করতে talk-কথা বলতে to-সাথে my-আমার attorney-আইনজীবীর] (আমাকে আমার আইনজীবীর সাথে কথা বলতে হবে।)
- Audience (অডিয়েন্স) - দর্শক [Noun] The audience enjoyed the show. [The-দর্শকরা audience-দর্শক enjoyed-উপভোগ করেছে the-অনুষ্ঠানটি show-অনুষ্ঠান] (দর্শকরা অনুষ্ঠানটি উপভোগ করেছে।)
- August (আগস্ট) - আগস্ট [Noun] I will go on vacation in August. [I-আমি will-যাব go-যাব on-এ vacation-ছুটিতে in-এ August-আগস্টে] (আমি আগস্টে ছুটিতে যাব।)
- Automatic (অটোম্যাটিক) - স্বয়ংক্রিয় [Adjective] This is an automatic machine. [This-এটা is-হয় an-একটি automatic-স্বয়ংক্রিয় machine-যন্ত্র] (এটা একটি স্বয়ংক্রিয় যন্ত্র।)
- Available (অ্যাভেইলেবল) - উপলব্ধ [Adjective] Is this book available? [Is-এই বইটি this book-এই বইটি available-উপলব্ধ] (এই বইটি কি উপলব্ধ?)
- Average (অ্যাভারেজ) - গড় [Noun] What is the average score? [What-কত is-হয় the-গড় average-গড় score-স্কোর] (গড় স্কোর কত?)
- Award (অ্যাওয়ার্ড) - পুরস্কার [Verb] He was awarded the first prize. [He-তাকে was-দেওয়া হয়েছিল awarded-পুরস্কৃত the-প্রথম first-প্রথম prize-পুরস্কার] (তাকে প্রথম পুরস্কার দেওয়া হয়েছিল।)
- Awkward (অকোয়ার্ড) - বিশ্রী [Adjective] There was an awkward silence. [There-সেখানে was-ছিল an-একটি awkward-বিশ্রী silence-নীরবতা] (সেখানে একটি বিশ্রী নীরবতা ছিল।)
- Ability (অ্যাবিলিটি) - ক্ষমতা [Noun] He has the ability to solve the problem. [He-তার has-আছে the-ক্ষমতা ability-ক্ষমতা to-করার solve-সমাধান the-সমস্যাটি problem-সমস্যা] (তার সমস্যাটি সমাধান করার ক্ষমতা আছে।)
- Abroad (অ্যাব্রড) - বিদেশে [Adverb] He is living abroad. [He-সে is-আছে living-বসবাস করছে abroad-বিদেশে] (সে বিদেশে বসবাস করছে।)
- Absence (অ্যাবসেন্স) - অনুপস্থিতি [Noun] His absence was noticed. [His-তার absence-অনুপস্থিতি was-লক্ষ্য করা হয়েছিল noticed-লক্ষ্য করা হয়েছিল] (তার অনুপস্থিতি লক্ষ্য করা হয়েছিল।)
- Absolutely (অ্যাবসলিউটলি) - একেবারে [Adverb] You are absolutely right. [You-তুমি are-হও absolutely-একেবারে right-সঠিক] (তুমি একেবারে সঠিক।)
- Absorb (অ্যাবসর্ব) - শোষণ করা [Verb] The sponge absorbs water. [The-স্পঞ্জ sponge-স্পঞ্জ absorbs-শোষণ করে water-জল] (স্পঞ্জ জল শোষণ করে।)
- Abstract (অ্যাবস্ট্রাক্ট) - বিমূর্ত [Adjective] This is an abstract painting. [This-এটা is-হয় an-একটি abstract-বিমূর্ত painting-চিত্র] (এটা একটি বিমূর্ত চিত্র।)
- Absurd (অ্যাবসার্ড) -荒谬 [Adjective] The idea is absurd. [The-ধারণাটি idea-ধারণা is-হয় absurd-অবাস্তব] (ধারণাটি অবাস্তব।)
- Abundance (অ্যাবান্ডান্স) - প্রাচুর্য [Noun] There is an abundance of food. [There-সেখানে is-আছে an-একটি abundance-প্রাচুর্য of-এর food-খাবারের] (সেখানে খাবারের প্রাচুর্য আছে।)
- Abuse (অ্যাবিউজ) - অপব্যবহার [Noun] He was a victim of child abuse. [He-সে was-ছিল a-একজন victim-শিকার of-এর child-শিশু abuse-নির্যাতনের] (সে শিশু নির্যাতনের শিকার ছিল।)
- Academic (অ্যাকাডেমিক) - শিক্ষাবিদ [Noun] He is a respected academic. [He-তিনি is-হন a-একজন respected-সম্মানিত academic-শিক্ষাবিদ] (তিনি একজন সম্মানিত শিক্ষাবিদ।)
- Accelerate (অ্যাক্সিলারেট) - ত্বরান্বিত করা [Verb] The car accelerated quickly. [The-গাড়িটি car-গাড়ি accelerated-ত্বরান্বিত হল quickly-দ্রুত] (গাড়িটি দ্রুত ত্বরান্বিত হল।)
- Accent (অ্যাকসেন্ট) - উচ্চারণ [Noun] He has a strong accent. [He-তার has-আছে a-একটি strong-জোরালো accent-উচ্চারণ] (তার একটি জোরালো উচ্চারণ আছে।)
- Accept (অ্যাক্সেপ্ট) - গ্রহণ করা [Verb] I accept your apology. [I-আমি accept-গ্রহণ করি your-তোমার apology-ক্ষমা] (আমি তোমার ক্ষমা গ্রহণ করি।)
- Acceptance (অ্যাক্সেপ্টেন্স) - গ্রহণযোগ্যতা [Noun] The proposal gained wide acceptance. [The-প্রস্তাবটি proposal-প্রস্তাব gained-অর্জন করেছে wide-ব্যাপক acceptance-গ্রহণযোগ্যতা] (প্রস্তাবটি ব্যাপক গ্রহণযোগ্যতা অর্জন করেছে।)
- Access (অ্যাক্সেস) - প্রবেশাধিকার [Noun] I have access to the library. [I-আমার have-আছে access-প্রবেশাধিকার to-এ the-লাইব্রেরিতে library-লাইব্রেরি] (আমার লাইব্রেরিতে প্রবেশাধিকার আছে।)
- Accessible (অ্যাক্সেসিবল) - সহজলভ্য [Adjective] The building is accessible to everyone. [The-ভবনটি building-ভবন is-হয় accessible-সহজলভ্য to-জন্য everyone-সবার] (ভবনটি সবার জন্য সহজলভ্য।)
- Accident (অ্যাক্সিডেন্ট) - দুর্ঘটনা [Noun] He had an accident. [He-তার had-হয়েছিল an-একটি accident-দুর্ঘটনা] (তার একটি দুর্ঘটনা হয়েছিল।)
- Accompany (অ্যাকোম্পানি) - সঙ্গ দেওয়া [Verb] I will accompany you. [I-আমি will-দেব accompany-সঙ্গ you-তোমাকে] (আমি তোমাকে সঙ্গ দেব।)
- Accomplish (অ্যাকমপ্লিশ) - সম্পন্ন করা [Verb] He accomplished his mission. [He-সে accomplished-সম্পন্ন করেছে his-তার mission-মিশন] (সে তার মিশন সম্পন্ন করেছে।)
- According (অ্যাকর্ডিং) - অনুসারে [Preposition] According to the news, it will rain tomorrow. [According-অনুসারে to-অনুসারে the-খবর news-খবর, it-এটা will-হবে rain-বৃষ্টি tomorrow-আগামীকাল] (খবর অনুসারে, আগামীকাল বৃষ্টি হবে।)
- Account (অ্যাকাউন্ট) - হিসাব [Noun] I have a bank account. [I-আমার have-আছে a-একটি bank-ব্যাঙ্ক account-হিসাব] (আমার একটি ব্যাঙ্ক হিসাব আছে।)
- Accountant (অ্যাকাউন্ট্যান্ট) - হিসাবরক্ষক [Noun] My father is an accountant. [My-আমার father-বাবা is-হন an-একজন accountant-হিসাবরক্ষক] (আমার বাবা একজন হিসাবরক্ষক।)
- Accuracy (অ্যাকিউরেসি) - নির্ভুলতা [Noun] The accuracy of the data is important. [The-নির্ভুলতা accuracy-নির্ভুলতা of-এর the-ডেটার data-ডেটা is-হয় important-গুরুত্বপূর্ণ] (ডেটার নির্ভুলতা গুরুত্বপূর্ণ।)
- Accuse (অ্যাকিউজ) - অভিযুক্ত করা [Verb] He was accused of theft. [He-তাকে was-করা হয়েছিল accused-অভিযুক্ত of-এর theft-চুরির] (তাকে চুরির অভিযোগে অভিযুক্ত করা হয়েছিল।)
- Achieve (অ্যাচিভ) - অর্জন করা [Verb] You can achieve your goals. [You-তুমি can-পারো achieve-অর্জন করতে your-তোমার goals-লক্ষ্য] (তুমি তোমার লক্ষ্য অর্জন করতে পারো।)
- Achievement (অ্যাচিভমেন্ট) - অর্জন [Noun] This is a great achievement. [This-এটা is-হয় a-একটি great-বড় achievement-অর্জন] (এটা একটি বড় অর্জন।)
- Acid (অ্যাসিড) - অম্ল [Noun] Lemon juice contains acid. [Lemon-লেবুর juice-রস contains-ধারণ করে acid-অম্ল] (লেবুর রস অম্ল ধারণ করে।)
- Acknowledge (অ্যাকনলেজ) - স্বীকার করা [Verb] He acknowledged his mistake. [He-সে acknowledged-স্বীকার করেছে his-তার mistake-ভুল] (সে তার ভুল স্বীকার করেছে।)
- Acquire (অ্যাকোয়ার) - অর্জন করা [Verb] He acquired a lot of wealth. [He-সে acquired-অর্জন করেছে a-অনেক lot-অনেক of-এর wealth-সম্পদ] (সে অনেক সম্পদ অর্জন করেছে।)
- Acquisition (অ্যাকুইজিশন) - অধিগ্রহণ [Noun] The company announced a new acquisition. [The-কোম্পানি company-কোম্পানি announced-ঘোষণা করেছে a-একটি new-নতুন acquisition-অধিগ্রহণের] (কোম্পানি একটি নতুন অধিগ্রহণের ঘোষণা করেছে।)
- Acre (একর) - একর [Noun] He owns 10 acres of land. [He-তার owns-মালিকানায় আছে 10-দশ acres-একর of-এর land-জমি] (তার মালিকানায় দশ একর জমি আছে।)
- Action (অ্যাকশন) - কাজ [Noun] Action speaks louder than words. [Action-কাজ speaks-কথা বলে louder-জোরে than-চেয়ে words-কথার] (কথার চেয়ে কাজ জোরে কথা বলে।)
- Active (অ্যাক্টিভ) - সক্রিয় [Adjective] He leads an active life. [He-তিনি leads-যাপন করেন an-একটি active-সক্রিয় life-জীবন] (তিনি একটি সক্রিয় জীবন যাপন করেন।)
- Activist (অ্যাক্টিভিস্ট) - কর্মী [Noun] He is a human rights activist. [He-তিনি is-হন a-একজন human-মানবাধিকার rights-অধিকার activist-কর্মী] (তিনি একজন মানবাধিকার কর্মী।)
- Activity (অ্যাক্টিভিটি) - কার্যকলাপ [Noun] What are your daily activities? [What-কি are-হয় your-তোমার daily-দৈনিক activities-কার্যকলাপ] (তোমার দৈনিক কার্যকলাপ কি?)
- Actor (অ্যাক্টর) - অভিনেতা [Noun] He is a famous actor. [He-তিনি is-হন a-একজন famous-বিখ্যাত actor-অভিনেতা] (তিনি একজন বিখ্যাত অভিনেতা।)
- Actress (অ্যাক্ট্রেস) - অভিনেত্রী [Noun] She is a talented actress. [She-তিনি is-হন a-একজন talented-প্রতিভাবান actress-অভিনেত্রী] (তিনি একজন প্রতিভাবান অভিনেত্রী।)
- Actual (অ্যাকচুয়াল) - প্রকৃত [Adjective] The actual cost was higher. [The-প্রকৃত actual-প্রকৃত cost-খরচ was-ছিল higher-বেশি] (প্রকৃত খরচ বেশি ছিল।)
- Actually (অ্যাকচুয়ালি) - আসলে [Adverb] Actually, I don't know. [Actually-আসলে, I-আমি don't-জানি না know-জানি] (আসলে, আমি জানি না।)
- Ad (অ্যাড) - বিজ্ঞাপন [Noun] I saw an ad on TV. [I-আমি saw-দেখেছি an-একটি ad-বিজ্ঞাপন on-এ TV-টিভিতে] (আমি টিভিতে একটি বিজ্ঞাপন দেখেছি।)
- Adapt (অ্যাডাপ্ট) - খাপ খাওয়ানো [Verb] You need to adapt to the new environment. [You-তোমাকে need-হবে to-করতে adapt-খাপ খাওয়াতে to-সাথে the-নতুন new-নতুন environment-পরিবেশের] (তোমাকে নতুন পরিবেশের সাথে খাপ খাওয়াতে হবে।)
- Addition (অ্যাডিশন) - সংযোজন [Noun] This is a new addition to the collection. [This-এটা is-হয় a-একটি new-নতুন addition-সংযোজন to-এ the-সংগ্রহে collection-সংগ্রহ] (এটা সংগ্রহে একটি নতুন সংযোজন।)
- Address (অ্যাড্রেস) - ঠিকানা [Noun] What is your address? [What-কি is-হয় your-তোমার address-ঠিকানা] (তোমার ঠিকানা কি?)
- Adjust (অ্যাডজাস্ট) - সমন্বয় করা [Verb] You need to adjust the settings. [You-তোমাকে need-হবে to-করতে adjust-সমন্বয় the-সেটিংস settings-সেটিংস] (তোমাকে সেটিংস সমন্বয় করতে হবে।)
- Adjustment (অ্যাডজাস্টমেন্ট) - সমন্বয় [Noun] I made some adjustments. [I-আমি made-করেছি some-কিছু adjustments-সমন্বয়] (আমি কিছু সমন্বয় করেছি।)
- Administration (অ্যাডমিনিস্ট্রেশন) - প্রশাসন [Noun] The school administration is very efficient. [The-স্কুলের school-স্কুল administration-প্রশাসন is-হয় very-খুব efficient-দক্ষ] (স্কুলের প্রশাসন খুব দক্ষ।)
- Administrator (অ্যাডমিনিস্ট্রেটর) - প্রশাসক [Noun] He is the new administrator. [He-তিনি is-হন the-নতুন new-নতুন administrator-প্রশাসক] (তিনি নতুন প্রশাসক।)
- Admire (অ্যাডমায়ার) - প্রশংসা করা [Verb] I admire her talent. [I-আমি admire-প্রশংসা করি her-তার talent-প্রতিভার] (আমি তার প্রতিভার প্রশংসা করি।)
- Admission (অ্যাডমিশন) - ভর্তি [Noun] I got admission to the university. [I-আমি got-পেয়েছি admission-ভর্তি to-এ the-বিশ্ববিদ্যালয়ে university-বিশ্ববিদ্যালয়] (আমি বিশ্ববিদ্যালয়ে ভর্তি পেয়েছি।)
- Adopt (অ্যাডপ্ট) - দত্তক নেওয়া [Verb] They decided to adopt a child. [They-তারা decided-সিদ্ধান্ত নিয়েছে to-নেওয়ার adopt-দত্তক a-একটি child-শিশু] (তারা একটি শিশু দত্তক নেওয়ার সিদ্ধান্ত নিয়েছে।)
- Adult (অ্যাডাল্ট) - প্রাপ্তবয়স্ক [Noun] He is an adult now. [He-সে is-হয় an-একজন adult-প্রাপ্তবয়স্ক now-এখন] (সে এখন একজন প্রাপ্তবয়স্ক।)
- Advance (অ্যাডভান্স) - অগ্রগতি [Noun] The army made an advance. [The-সেনাবাহিনী army-সেনাবাহিনী made-করেছে an-একটি advance-অগ্রগতি] (সেনাবাহিনী একটি অগ্রগতি করেছে।)
- Advantage (অ্যাডভান্টেজ) - সুবিধা [Noun] What is the advantage of this? [What-কি is-হয় the-সুবিধা advantage-সুবিধা of-এর this-এটার] (এটার সুবিধা কি?)
- Adventure (অ্যাডভেঞ্চার) - দুঃসাহসিক কাজ [Noun] Life is an adventure. [Life-জীবন is-হয় an-একটি adventure-দুঃসাহসিক কাজ] (জীবন একটি দুঃসাহসিক কাজ।)
- Advertising (অ্যাডভার্টাইজিং) - বিজ্ঞাপন [Noun] The company spends a lot on advertising. [The-কোম্পানি company-কোম্পানি spends-ব্যয় করে a-অনেক lot-অনেক on-জন্য advertising-বিজ্ঞাপনের] (কোম্পানি বিজ্ঞাপনের জন্য অনেক ব্যয় করে।)
- Advice (অ্যাডভাইস) - উপদেশ [Noun] Can you give me some advice? [Can-তুমি কি you-তুমি give-দিতে পারো me-আমাকে some-কিছু advice-উপদেশ] (তুমি কি আমাকে কিছু উপদেশ দিতে পারো?)
- Advocate (অ্যাডভোকেট) - উকিল [Noun] He is a famous advocate. [He-তিনি is-হন a-একজন famous-বিখ্যাত advocate-উকিল] (তিনি একজন বিখ্যাত উকিল।)
- Affair (অ্যাফেয়ার) - ব্যাপার [Noun] It is a private affair. [It-এটা is-হয় a-একটি private-ব্যক্তিগত affair-ব্যাপার] (এটা একটি ব্যক্তিগত ব্যাপার।)
- Affect (অ্যাফেক্ট) - প্রভাবিত করা [Verb] The weather affects my mood. [The-আবহাওয়া weather-আবহাওয়া affects-প্রভাবিত করে my-আমার mood-মেজাজ] (আবহাওয়া আমার মেজাজ প্রভাবিত করে।)
- Afford (অ্যাফোর্ড) - সামর্থ্য থাকা [Verb] I can't afford a new car. [I-আমার can't-নেই afford-সামর্থ্য a-একটি new-নতুন car-গাড়ির] (আমার একটি নতুন গাড়ি কেনার সামর্থ্য নেই।)
- Afraid (অ্যাফ্রেইড) - ভীত [Adjective] I am afraid of spiders. [I-আমি am-হই afraid-ভীত of-এর spiders-মাকড়সার] (আমি মাকড়সার ভয়ে ভীত।)
- After (আফটার) - পরে [Preposition] I will call you after lunch. [I-আমি will-করব call-ফোন you-তোমাকে after-পরে lunch-দুপুরের খাবারের] (আমি তোমাকে দুপুরের খাবারের পরে ফোন করব।)
- Again (অ্যাগেইন) - আবার [Adverb] Please say it again. [Please-দয়া করে say-বলুন it-এটা again-আবার] (দয়া করে এটা আবার বলুন।)
- Against (অ্যাগেইনস্ট) - বিরুদ্ধে [Preposition] He is against the proposal. [He-সে is-হয় against-বিরুদ্ধে the-প্রস্তাবটির proposal-প্রস্তাব] (সে প্রস্তাবটির বিরুদ্ধে।)
- Agency (এজেন্সি) - সংস্থা [Noun] I work for a government agency. [I-আমি work-কাজ করি for-জন্য a-একটি government-সরকারি agency-সংস্থায়] (আমি একটি সরকারি সংস্থায় কাজ করি।)
- Aggressive (অ্যাগ্রেসিভ) - আক্রমণাত্মক [Adjective] He has an aggressive personality. [He-তার has-আছে an-একটি aggressive-আক্রমণাত্মক personality-ব্যক্তিত্ব] (তার একটি আক্রমণাত্মক ব্যক্তিত্ব আছে।)
- Ago (এগো) - আগে [Adverb] I saw him two days ago. [I-আমি saw-দেখেছিলাম him-তাকে two-দুই days-দিন ago-আগে] (আমি তাকে দুই দিন আগে দেখেছিলাম।)
- Agree (এগ্রি) - একমত হওয়া [Verb] I agree with your opinion. [I-আমি agree-একমত with-সাথে your-তোমার opinion-মতের] (আমি তোমার মতের সাথে একমত।)
- Agreement (এগ্রিমেন্ট) - চুক্তি [Noun] We signed an agreement. [We-আমরা signed-স্বাক্ষর করেছি an-একটি agreement-চুক্তি] (আমরা একটি চুক্তি স্বাক্ষর করেছি।)
- Agriculture (এগ্রিকালচার) - কৃষি [Noun] Agriculture is the backbone of our economy. [Agriculture-কৃষি is-হয় the-মেরুদণ্ড backbone-মেরুদণ্ড of-এর our-আমাদের economy-অর্থনীতির] (কৃষি আমাদের অর্থনীতির মেরুদণ্ড।)
- Ahead (এহেড) - সামনে [Adverb] Look ahead. [Look-তাকাও ahead-সামনে] (সামনে তাকাও।)
- Aid (এইড) - সাহায্য [Verb] We should aid the poor. [We-আমাদের should-উচিত aid-সাহায্য করা the-গরিবদের poor-গরিব] (আমাদের গরিবদের সাহায্য করা উচিত।)
- Aim (এইম) - লক্ষ্য [Noun] What is your aim in life? [What-কি is-হয় your-তোমার aim-লক্ষ্য in-এ life-জীবনে] (তোমার জীবনের লক্ষ্য কি?)
- Air (এয়ার) - বাতাস [Noun] The air is fresh here. [The-বাতাস air-বাতাস is-হয় fresh-বিশুদ্ধ here-এখানে] (এখানকার বাতাস বিশুদ্ধ।)
- Aircraft (এয়ারক্রাফট) - বিমান [Noun] The aircraft landed safely. [The-বিমানটি aircraft-বিমান landed-অবতরণ করেছে safely- নিরাপদে] (বিমানটি নিরাপদে অবতরণ করেছে।)
- Airline (এয়ারলাইন) - বিমান সংস্থা [Noun] I booked a ticket with a new airline. [I-আমি booked-বুক করেছি a-একটি ticket-টিকিট with-সাথে a-একটি new-নতুন airline-বিমান সংস্থার] (আমি একটি নতুন বিমান সংস্থার সাথে একটি টিকিট বুক করেছি।)
- Airport (এয়ারপোর্ট) - বিমানবন্দর [Noun] I am going to the airport. [I-আমি am-যাচ্ছি going-যাচ্ছি to-এ the-বিমানবন্দরে airport-বিমানবন্দর] (আমি বিমানবন্দরে যাচ্ছি।)
- Alarm (অ্যালার্ম) - বিপদ সংকেত [Noun] The alarm clock woke me up. [The-অ্যালার্ম alarm-অ্যালার্ম clock-ঘড়ি woke-জাগিয়ে দিয়েছে me-আমাকে up-উপরে] (অ্যালার্ম ঘড়ি আমাকে জাগিয়ে দিয়েছে।)
- Album (অ্যালবাম) - অ্যালবাম [Noun] She showed me her photo album. [She-সে showed-দেখিয়েছে me-আমাকে her-তার photo-ছবির album-অ্যালবাম] (সে আমাকে তার ছবির অ্যালবাম দেখিয়েছে।)
- Alcohol (অ্যালকোহল) - মদ [Noun] Drinking alcohol is bad for health. [Drinking-পান করা alcohol-মদ is-হয় bad-খারাপ for-জন্য health-স্বাস্থ্যের] (মদ পান করা স্বাস্থ্যের জন্য খারাপ।)
- Alive (অ্যালাইভ) - জীবিত [Adjective] Is he still alive? [Is-সে কি he-সে still-এখনও alive-জীবিত] (সে কি এখনও জীবিত?)
- All (অল) - সব [Determiner] All the students passed the exam. [All-সব the-ছাত্রছাত্রীরা students-ছাত্রছাত্রী passed-পাশ করেছে the-পরীক্ষায় exam-পরীক্ষা] (সব ছাত্রছাত্রীরা পরীক্ষায় পাশ করেছে।)
- Allow (অ্যালাউ) - অনুমতি দেওয়া [Verb] My parents don't allow me to go out at night. [My-আমার parents-বাবা-মা don't-দেয় না allow-অনুমতি me-আমাকে to-যেতে go-যেতে out-বাইরে at-এ night-রাতে] (আমার বাবা-মা আমাকে রাতে বাইরে যেতে দেয় না।)
- Ally (অ্যালাই) - মিত্র [Noun] They are our allies in the war. [They-তারা are-হয় our-আমাদের allies-মিত্র in-এ the-যুদ্ধে war-যুদ্ধ] (তারা যুদ্ধে আমাদের মিত্র।)
- Almost (অলমোস্ট) - প্রায় [Adverb] The work is almost finished. [The-কাজটি work-কাজ is-হয় almost-প্রায় finished-শেষ] (কাজটি প্রায় শেষ।)
- Alone (অ্যালোন) - একা [Adjective] I like to be alone sometimes. [I-আমি like-পছন্দ করি to-থাকতে be-থাকতে alone-একা sometimes-মাঝে মাঝে] (আমি মাঝে মাঝে একা থাকতে পছন্দ করি।)
- Along (অ্যালং) - বরাবর [Preposition] We walked along the beach. [We-আমরা walked-হেঁটেছিলাম along-বরাবর the-সৈকত beach-সৈকত] (আমরা সৈকত বরাবর হেঁটেছিলাম।)
- Already (অলরেডি) - ইতিমধ্যে [Adverb] He has already left. [He-সে has-চলে গেছে already-ইতিমধ্যে left-চলে গেছে] (সে ইতিমধ্যে চলে গেছে।)
- Also (অলসো) - এছাড়াও [Adverb] She is beautiful and also intelligent. [She-সে is-হয় beautiful-সুন্দর and-এবং also-এছাড়াও intelligent-বুদ্ধিমান] (সে সুন্দর এবং এছাড়াও বুদ্ধিমান।)
- Alter (অল্টার) - পরিবর্তন করা [Verb] We need to alter our plans. [We-আমাদের need-হবে to-করতে alter-পরিবর্তন our-আমাদের plans-পরিকল্পনা] (আমাদের পরিকল্পনা পরিবর্তন করতে হবে।)
- Alternative (অল্টারনেটিভ) - বিকল্প [Adjective] Is there an alternative route? [Is-আছে there-সেখানে an-একটি alternative-বিকল্প route-পথ] (সেখানে কি একটি বিকল্প পথ আছে?)
- Although (অলদো) - যদিও [Conjunction] Although he is rich, he is not happy. [Although-যদিও he-সে is-হয় rich-ধনী, he-সে is-নয় not-নয় happy-সুখী] (যদিও সে ধনী, সে সুখী নয়।)
- Altogether (অলটুগেদার) - পুরোপুরি [Adverb] I am not altogether sure. [I-আমি am-নই not-নই altogether-পুরোপুরি sure-নিশ্চিত] (আমি পুরোপুরি নিশ্চিত নই।)
- Always (অলওয়েজ) - সর্বদা [Adverb] He is always late. [He-সে is-হয় always-সর্বদা late-দেরি] (সে সর্বদা দেরি করে।)
- Amaze (অ্যামেজ) - বিস্মিত করা [Verb] His talent never ceases to amaze me. [His-তার talent-প্রতিভা never-কখনও ceases-বন্ধ করে না to-করতে amaze-বিস্মিত me-আমাকে] (তার প্রতিভা আমাকে কখনও বিস্মিত করতে বন্ধ করে না।)
- Ambassador (অ্যাম্বাসেডর) - রাষ্ট্রদূত [Noun] He is the new ambassador to Japan. [He-তিনি is-হন the-নতুন new-নতুন ambassador-রাষ্ট্রদূত to-এ Japan-জাপানে] (তিনি জাপানে নতুন রাষ্ট্রদূত।)
- Ambition (অ্যাম্বিশন) - উচ্চাকাঙ্ক্ষা [Noun] His ambition is to become a successful businessman. [His-তার ambition-উচ্চাকাঙ্ক্ষা is-হয় to-হওয়া become-হওয়া a-একজন successful-সফল businessman-ব্যবসায়ী] (তার উচ্চাকাঙ্ক্ষা হল একজন সফল ব্যবসায়ী হওয়া।)
- Ambulance (অ্যাম্বুলেন্স) - অ্যাম্বুলেন্স [Noun] The ambulance arrived quickly. [The-অ্যাম্বুলেন্স ambulance-অ্যাম্বুলেন্স arrived-পৌঁছেছে quickly-তাড়াতাড়ি] (অ্যাম্বুলেন্স তাড়াতাড়ি পৌঁছেছে।)
- Amen (আমেন) - আমেন [Interjection] Amen to that! [Amen-আমেন to-এতে that-ওটাতে] (ওটাতে আমেন!)
- Amend (অ্যামেন্ড) - সংশোধন করা [Verb] We need to amend the constitution. [We-আমাদের need-হবে to-করতে amend-সংশোধন the-সংবিধান constitution-সংবিধান] (আমাদের সংবিধান সংশোধন করতে হবে।)
- Amendment (অ্যামেন্ডমেন্ট) - সংশোধন [Noun] They proposed an amendment to the law. [They-তারা proposed-প্রস্তাব করেছে an-একটি amendment-সংশোধন to-এ the-আইনে law-আইন] (তারা আইনে একটি সংশোধন প্রস্তাব করেছে।)
- Amid (অ্যামিড) - মধ্যে [Preposition] He was standing amid the crowd. [He-সে was-দাঁড়িয়ে ছিল standing-দাঁড়িয়ে ছিল amid-মধ্যে the-ভিড়ের crowd-ভিড়] (সে ভিড়ের মধ্যে দাঁড়িয়ে ছিল।)
- Among (অ্যামাং) - মধ্যে [Preposition] Divide the apples among the children. [Divide-ভাগ কর the-আপেলগুলো apples-আপেল among-মধ্যে the-শিশুদের children-শিশু] (আপেলগুলো শিশুদের মধ্যে ভাগ কর।)
- Amount (অ্যামাউন্ট) - পরিমাণ [Noun] A large amount of money was stolen. [A-একটি large-বড় amount-পরিমাণ of-এর money-টাকা was-হয়েছিল stolen-চুরি] (একটি বড় পরিমাণ টাকা চুরি হয়েছিল।)
- Ample (অ্যাম্পল) - প্রচুর [Adjective] We have ample time. [We-আমাদের have-আছে ample-প্রচুর time-সময়] (আমাদের প্রচুর সময় আছে।)
- Amuse (অ্যামিউজ) - আনন্দ দেওয়া [Verb] The clown amused the children. [The-জোকার clown-জোকার amused-আনন্দ দিয়েছে the-শিশুদের children-শিশু] (জোকার শিশুদের আনন্দ দিয়েছে।)
- Analogy (অ্যানালজি) - সাদৃশ্য [Noun] He drew an analogy between the brain and a computer. [He-সে drew-টেনেছে an-একটি analogy-সাদৃশ্য between-মধ্যে the-মস্তিষ্কের brain-মস্তিষ্ক and-এবং a-একটি computer-কম্পিউটারের] (সে মস্তিষ্ক এবং একটি কম্পিউটারের মধ্যে একটি সাদৃশ্য টেনেছে।)
- Analyze (অ্যানালাইজ) - বিশ্লেষণ করা [Verb] We need to analyze the data. [We-আমাদের need-হবে to-করতে analyze-বিশ্লেষণ the-ডেটা data-ডেটা] (আমাদের ডেটা বিশ্লেষণ করতে হবে।)
- Ancestor (অ্যানসেস্টর) - পূর্বপুরুষ [Noun] My ancestors came from Ireland. [My-আমার ancestors-পূর্বপুরুষরা came-এসেছিল from-থেকে Ireland-আয়ারল্যান্ড] (আমার পূর্বপুরুষরা আয়ারল্যান্ড থেকে এসেছিল।)
- Anchor (অ্যাঙ্কর) - নোঙ্গর [Verb] We anchored the boat. [We-আমরা anchored-নোঙ্গর করেছি the-নৌকাটি boat-নৌকা] (আমরা নৌকাটি নোঙ্গর করেছি।)
- Ancient (এনশিয়েন্ট) - প্রাচীন [Adjective] I love ancient history. [I-আমি love-ভালোবাসি ancient-প্রাচীন history-ইতিহাস] (আমি প্রাচীন ইতিহাস ভালোবাসি।)
- Angel (অ্যাঞ্জেল) - দেবদূত [Noun] She has the voice of an angel. [She-তার has-আছে the-কণ্ঠ voice-কণ্ঠ of-এর an-একজন angel-দেবদূতের] (তার কণ্ঠ একজন দেবদূতের মতো।)
- Anger (অ্যাঙ্গার) - রাগ [Noun] He could not control his anger. [He-সে could-পারেনি not-না control-নিয়ন্ত্রণ করতে his-তার anger-রাগ] (সে তার রাগ নিয়ন্ত্রণ করতে পারেনি।)
- Angle (অ্যাঙ্গেল) - কোণ [Noun] The camera was at a strange angle. [The-ক্যামেরাটি camera-ক্যামেরা was-ছিল at-এ a-একটি strange-অদ্ভুত angle-কোণে] (ক্যামেরাটি একটি অদ্ভুত কোণে ছিল।)
- Angry (অ্যাংরি) - রাগান্বিত [Adjective] Why are you so angry? [Why-কেন are-তুমি you-তুমি so-এত angry-রাগান্বিত] (তুমি এত রাগান্বিত কেন?)
- Animal (অ্যানিম্যাল) - পশু [Noun] The dog is a domestic animal. [The-কুকুর dog-কুকুর is-হয় a-একটি domestic-গৃহপালিত animal-পশু] (কুকুর একটি গৃহপালিত পশু।)
- Ankle (অ্যাঙ্কল) - গোড়ালি [Noun] I twisted my ankle. [I-আমি twisted-মুচড়ে ফেলেছি my-আমার ankle-গোড়ালি] (আমি আমার গোড়ালি মুচড়ে ফেলেছি।)
- Anniversary (অ্যানিভার্সারি) - বার্ষিকী [Noun] We are celebrating our 10th anniversary. [We-আমরা are-করছি celebrating-উদযাপন our-আমাদের 10th-দশম anniversary-বার্ষিকী] (আমরা আমাদের দশম বার্ষিকী উদযাপন করছি।)
- Announce (অ্যানাউন্স) - ঘোষণা করা [Verb] The winner will be announced tomorrow. [The-বিজয়ী winner-বিজয়ী will-হবে be-হবে announced-ঘোষিত tomorrow-আগামীকাল] (বিজয়ী আগামীকাল ঘোষিত হবে।)
- Annoy (অ্যানয়) - বিরক্ত করা [Verb] His constant talking annoys me. [His-তার constant-অবিরাম talking-কথা বলা annoys-বিরক্ত করে me-আমাকে] (তার অবিরাম কথা বলা আমাকে বিরক্ত করে।)
- Annual (অ্যানুয়াল) - বার্ষিক [Adjective] The company holds an annual meeting. [The-কোম্পানি company-কোম্পানি holds-অনুষ্ঠিত করে an-একটি annual-বার্ষিক meeting-সভা] (কোম্পানি একটি বার্ষিক সভা অনুষ্ঠিত করে।)
- Another (অ্যানাদার) - অন্য [Determiner] Would you like another drink? [Would-তুমি কি you-তুমি like-চাও another-অন্য drink-পানীয়] (তুমি কি অন্য পানীয় চাও?)
- Answer (আনসার) - উত্তর [Verb] Please answer the question. [Please-দয়া করে answer-উত্তর দিন the-প্রশ্নটির question-প্রশ্ন] (দয়া করে প্রশ্নটির উত্তর দিন।)
- Anxious (অ্যাংশাস) - উদ্বিগ্ন [Adjective] She is anxious about her son's health. [She-তিনি is-হন anxious-উদ্বিগ্ন about-নিয়ে her-তার son's-ছেলের health-স্বাস্থ্য] (তিনি তার ছেলের স্বাস্থ্য নিয়ে উদ্বিগ্ন।)
- Any (এনি) - কোন [Determiner] Do you have any money? [Do-তোমার কি you-তোমার have-আছে any-কোন money-টাকা] (তোমার কি কোন টাকা আছে?)
- Anybody (এনিবডি) - যে কেউ [Pronoun] Is anybody home? [Is-কেউ কি anybody-কেউ home-বাড়িতে] (কেউ কি বাড়িতে আছে?)
- Anymore (এনিমোর) - আর [Adverb] I don't love you anymore. [I-আমি don't-বাসি না love-ভালোবাসি you-তোমাকে anymore-আর] (আমি তোমাকে আর ভালোবাসি না।)
- Anyone (এনিওয়ান) - যে কেউ [Pronoun] Can anyone help me? [Can-কেউ কি anyone-কেউ help-সাহায্য করতে পারে me-আমাকে] (কেউ কি আমাকে সাহায্য করতে পারে?)
- Anything (এনিথিং) - কিছু [Pronoun] I don't want anything to eat. [I-আমি don't-চাই না want-চাই anything-কিছু to-খেতে eat-খেতে] (আমি কিছু খেতে চাই না।)
- Anyway (এনিওয়ে) - যাইহোক [Adverb] Anyway, it's too late now. [Anyway-যাইহোক, it's-এটা too-খুব late-দেরি now-এখন] (যাইহোক, এখন খুব দেরি হয়ে গেছে।)
- Anywhere (এনিহোয়্যার) - যে কোন জায়গায় [Adverb] We can go anywhere you like. [We-আমরা can-যেতে পারি go-যেতে anywhere-যে কোন জায়গায় you-তুমি like-পছন্দ কর] (তুমি যেখানে পছন্দ কর আমরা সেখানে যেতে পারি।)
- Apart (অ্যাপার্ট) - আলাদা [Adverb] They are living apart. [They-তারা are-আছে living-বসবাস করছে apart-আলাদা] (তারা আলাদা বসবাস করছে।)
- Apartment (অ্যাপার্টমেন্ট) - অ্যাপার্টমেন্ট [Noun] I live in a small apartment. [I-আমি live-থাকি in-a-একটি small-ছোট apartment-অ্যাপার্টমেন্টে] (আমি একটি ছোট অ্যাপার্টমেন্টে থাকি।)
- Apology (অ্যাপোলজি) - ক্ষমা [Noun] I owe you an apology. [I-আমি owe-ঋণী you-তোমার কাছে an-একটি apology-ক্ষমার] (আমি তোমার কাছে একটি ক্ষমার ঋণী।)
- Appall (অ্যাপল) - আতঙ্কিত করা [Verb] The news will appall you. [The-খবরটি news-খবর will-করবে appall-আতঙ্কিত you-তোমাকে] (খবরটি তোমাকে আতঙ্কিত করবে।)
- Apparent (অ্যাপারেন্ট) - স্পষ্ট [Adjective] It is apparent that he is lying. [It-এটা is-হয় apparent-স্পষ্ট that-যে he-সে is-বলছে lying-মিথ্যা] (এটা স্পষ্ট যে সে মিথ্যা বলছে।)
- Appeal (আপিল) - আবেদন [Verb] He appealed to the court. [He-সে appealed-আবেদন করেছে to-কাছে the-আদালতের court-আদালত] (সে আদালতের কাছে আবেদন করেছে।)
- Appear (অ্যাপিয়ার) - উপস্থিত হওয়া [Verb] He appeared out of nowhere. [He-সে appeared-উপস্থিত হল out-থেকে of-এর nowhere-কোথাও] (সে কোথাও থেকে উপস্থিত হল।)
- Appearance (অ্যাপিয়ারেন্স) - চেহারা [Noun] She has a beautiful appearance. [She-তার has-আছে a-একটি beautiful-সুন্দর appearance-চেহারা] (তার একটি সুন্দর চেহারা আছে।)
- Appetite (অ্যাপেটাইট) - ক্ষুধা [Noun] I have a good appetite. [I-আমার have-আছে a-একটি good-ভালো appetite-ক্ষুধা] (আমার ভালো ক্ষুধা আছে।)
- Applaud (অ্যাপ্লড) - করতালি দেওয়া [Verb] The audience applauded loudly. [The-দর্শকরা audience-দর্শক applauded-করতালি দিয়েছে loudly-জোরে] (দর্শকরা জোরে করতালি দিয়েছে।)
- Apple (অ্যাপেল) - আপেল [Noun] An apple a day keeps the doctor away. [An-একটি apple-আপেল a-প্রতি day-দিন keeps-রাখে the-ডাক্তারকে doctor-ডাক্তার away-দূরে] (প্রতিদিন একটি আপেল ডাক্তারকে দূরে রাখে।)
- Applicant (অ্যাপ্লিক্যান্ট) - আবেদনকারী [Noun] There are many applicants for the job. [There-সেখানে are-আছে many-অনেক applicants-আবেদনকারী for-জন্য the-চাকরিটির job-চাকরি] (চাকরিটির জন্য অনেক আবেদনকারী আছে।)
- Application (অ্যাপ্লিকেশন) - আবেদনপত্র [Noun] Please fill out this application form. [Please-দয়া করে fill-পূরণ করুন out-বাইরে this-এই application-আবেদনপত্র form-ফর্ম] (দয়া করে এই আবেদনপত্রটি পূরণ করুন।)
- Apply (অ্যাপ্লাই) - আবেদন করা [Verb] I want to apply for this job. [I-আমি want-চাই to-করতে apply-আবেদন for-জন্য this-এই job-চাকরিটির] (আমি এই চাকরিটির জন্য আবেদন করতে চাই।)
- Appoint (অ্যাপয়েন্ট) - নিয়োগ করা [Verb] They appointed him as the new chairman. [They-তারা appointed-নিয়োগ করেছে him-তাকে as-হিসাবে the-নতুন new-নতুন chairman-চেয়ারম্যান] (তারা তাকে নতুন চেয়ারম্যান হিসাবে নিয়োগ করেছে।)
- Appointment (অ্যাপয়েন্টমেন্ট) - সাক্ষাৎ [Noun] I have a doctor's appointment. [I-আমার have-আছে a-একটি doctor's-ডাক্তারের appointment-সাক্ষাৎ] (আমার একটি ডাক্তারের সাক্ষাৎ আছে।)
- Appreciate (অ্যাপ্রিশিয়েট) - প্রশংসা করা [Verb] I really appreciate your help. [I-আমি really-সত্যিই appreciate-প্রশংসা করি your-তোমার help-সাহায্যের] (আমি সত্যিই তোমার সাহায্যের প্রশংসা করি।)
- Appreciation (অ্যাপ্রিসিয়েশন) - প্রশংসা [Noun] He showed his appreciation with a gift. [He-সে showed-দেখিয়েছে his-তার appreciation-প্রশংসা with-দিয়ে a-একটি gift-উপহার] (সে একটি উপহার দিয়ে তার প্রশংসা দেখিয়েছে।)
- Approach (অ্যাপ্রোচ) - পদ্ধতি [Noun] We need a new approach to the problem. [We-আমাদের need-দরকার a-একটি new-নতুন approach-পদ্ধতি to-এর the-সমস্যাটির problem-সমস্যা] (আমাদের সমস্যাটির জন্য একটি নতুন পদ্ধতি দরকার।)
- Appropriate (অ্যাপ্রোপিয়েইট) - উপযুক্ত [Adjective] Wear appropriate clothes for the interview. [Wear-পরুন appropriate-উপযুক্ত clothes-পোশাক for-জন্য the-সাক্ষাৎকারের interview-সাক্ষাৎকার] (সাক্ষাৎকারের জন্য উপযুক্ত পোশাক পরুন।)
- Approval (অ্যাপ্রুভাল) - অনুমোদন [Noun] The plan has been given approval. [The-পরিকল্পনাটি plan-পরিকল্পনা has-পেয়েছে been-পেয়েছে given-দেওয়া approval-অনুমোদন] (পরিকল্পনাটি অনুমোদন পেয়েছে।)
- Approve (অ্যাপ্রুভ) - অনুমোদন করা [Verb] My parents approved of my decision. [My-আমার parents-বাবা-মা approved-অনুমোদন করেছে of-এর my-আমার decision-সিদ্ধান্তের] (আমার বাবা-মা আমার সিদ্ধান্তের অনুমোদন করেছে।)
- Approximate (অ্যাপ্রক্সিমেট) - আনুমানিক [Adjective] The approximate cost is $100. [The-আনুমানিক approximate-আনুমানিক cost-খরচ is-হয় $100-$100] (আনুমানিক খরচ $100।)
- April (এপ্রিল) - এপ্রিল [Noun] April is the fourth month of the year. [April-এপ্রিল is-হয় the-চতুর্থ fourth-চতুর্থ month-মাস of-এর the-বছরের year-বছর] (এপ্রিল বছরের চতুর্থ মাস।)
- Architect (আর্কিটেক্ট) - স্থপতি [Noun] He is a famous architect. [He-তিনি is-হন a-একজন famous-বিখ্যাত architect-স্থপতি] (তিনি একজন বিখ্যাত স্থপতি।)
- Architecture (আর্কিটেকচার) - স্থাপত্য [Noun] I am studying architecture. [I-আমি am-পড়ছি studying-পড়ছি architecture-স্থাপত্য] (আমি স্থাপত্য পড়ছি।)
- Argue (আর্গিউ) - তর্ক করা [Verb] I don't want to argue with you. [I-আমি don't-চাই না want-চাই to-করতে argue-তর্ক with-সাথে you-তোমার] (আমি তোমার সাথে তর্ক করতে চাই না।)
- Argument (আর্গুমেন্ট) - তর্ক [Noun] We had a long argument. [We-আমরা had-করেছিলাম a-একটি long-দীর্ঘ argument-তর্ক] (আমরা একটি দীর্ঘ তর্ক করেছিলাম।)
- Arise (অ্যারাইজ) - ওঠা [Verb] A new problem has arisen. [A-একটি new-নতুন problem-সমস্যা has-উঠেছে arisen-উঠেছে] (একটি নতুন সমস্যা উঠেছে।)
- Arm (আর্ম) - বাহু [Noun] He broke his arm. [He-সে broke-ভেঙেছে his-তার arm-বাহু] (সে তার বাহু ভেঙেছে।)
- Army (আর্মি) - সেনাবাহিনী [Noun] He joined the army. [He-সে joined-যোগ দিয়েছে the-সেনাবাহিনীতে army-সেনাবাহিনী] (সে সেনাবাহিনীতে যোগ দিয়েছে।)
- Around (অ্যারাউন্ড) - চারপাশে [Adverb] I looked around, but I couldn't see anyone. [I-আমি looked-তাকিয়েছিলাম around-চারপাশে, but-কিন্তু I-আমি couldn't-পারিনি see-দেখতে anyone-কাউকে] (আমি চারপাশে তাকিয়েছিলাম, কিন্তু আমি কাউকে দেখতে পাইনি।)
- Arrange (অ্যারেঞ্জ) - ব্যবস্থা করা [Verb] Can you arrange a taxi for me? [Can-তুমি কি you-তুমি arrange-ব্যবস্থা করতে পারো a-একটি taxi-ট্যাক্সির for-জন্য me-আমার] (তুমি কি আমার জন্য একটি ট্যাক্সির ব্যবস্থা করতে পারো?)
- Arrangement (অ্যারেঞ্জমেন্ট) - ব্যবস্থা [Noun] Everything is under arrangement. [Everything-সবকিছু is-আছে under-অধীনে arrangement-ব্যবস্থার] (সবকিছু ব্যবস্থার অধীনে আছে।)
- Arrest (অ্যারেস্ট) - গ্রেপ্তার [Noun] The police made an arrest. [The-পুলিশ police-পুলিশ made-করেছে an-একটি arrest-গ্রেপ্তার] (পুলিশ একটি গ্রেপ্তার করেছে।)
- Arrival (অ্যারাইভাল) - আগমন [Noun] We are waiting for his arrival. [We-আমরা are-করছি waiting-অপেক্ষা for-জন্য his-তার arrival-আগমনের] (আমরা তার আগমনের জন্য অপেক্ষা করছি।)
- Arrive (অ্যারাইভ) - পৌঁছানো [Verb] What time does the train arrive? [What-কোন time-সময়ে does-পৌঁছায় the-ট্রেনটি train-ট্রেন arrive-পৌঁছায়] (ট্রেনটি কোন সময়ে পৌঁছায়?)
- Arrow (অ্যারো) - তীর [Noun] He shot an arrow from his bow. [He-সে shot-ছুড়েছে an-একটি arrow-তীর from-থেকে his-তার bow-ধনুক] (সে তার ধনুক থেকে একটি তীর ছুড়েছে।)
- Art (আর্ট) - শিল্প [Noun] I am interested in modern art. [I-আমি am-আগ্রহী interested-আগ্রহী in-এ modern-আধুনিক art-শিল্পে] (আমি আধুনিক শিল্পে আগ্রহী।)
- Article (আর্টিকেল) - প্রবন্ধ [Noun] I read an interesting article in the newspaper. [I-আমি read-পড়েছি an-একটি interesting-আকর্ষণীয় article-প্রবন্ধ in-এ the-সংবাদপত্রে newspaper-সংবাদপত্র] (আমি সংবাদপত্রে একটি আকর্ষণীয় প্রবন্ধ পড়েছি।)
- Artificial (আর্টিফিশিয়াল) - কৃত্রিম [Adjective] This plant is artificial. [This-এই plant-গাছটি is-হয় artificial-কৃত্রিম] (এই গাছটি কৃত্রিম।)
- Artist (আর্টিস্ট) - শিল্পী [Noun] My brother is an artist. [My-আমার brother-ভাই is-হয় an-একজন artist-শিল্পী] (আমার ভাই একজন শিল্পী।)
- Ashamed (অ্যাশেমড) - লজ্জিত [Adjective] I am ashamed of my mistake. [I-আমি am-লজ্জিত ashamed-লজ্জিত of-এর my-আমার mistake-ভুলের] (আমি আমার ভুলের জন্য লজ্জিত।)
- Aside (অ্যাসাইড) - একপাশে [Adverb] He took me aside to talk. [He-সে took-নিয়ে গেল me-আমাকে aside-একপাশে to-করতে talk-কথা বলতে] (সে আমাকে কথা বলতে একপাশে নিয়ে গেল।)
- Ask (আস্ক) - জিজ্ঞাসা করা [Verb] Can I ask you a question? [Can-পারি I-আমি ask-জিজ্ঞাসা করতে you-তোমাকে a-একটি question-প্রশ্ন] (আমি কি তোমাকে একটি প্রশ্ন জিজ্ঞাসা করতে পারি?)
- Asleep (অ্যাস্লিপ) - ঘুমন্ত [Adjective] The cat is fast asleep. [The-বিড়ালটি cat-বিড়াল is-আছে fast-গভীর asleep-ঘুমন্ত] (বিড়ালটি গভীর ঘুমে আছে।)
- Aspect (অ্যাসপেক্ট) - দিক [Noun] We must consider every aspect of the problem. [We-আমাদের must-অবশ্যই consider-বিবেচনা করতে হবে every-প্রতিটি aspect-দিক of-এর the-সমস্যাটির problem-সমস্যা] (আমাদের সমস্যাটির প্রতিটি দিক অবশ্যই বিবেচনা করতে হবে।)
- Assemble (অ্যাসেম্বল) - একত্রিত করা [Verb] The students assembled in the hall. [The-ছাত্রছাত্রীরা students-ছাত্রছাত্রী assembled-একত্রিত হল in-এ the-হলে hall-হল] (ছাত্রছাত্রীরা হলে একত্রিত হল।)
- Assembly (অ্যাসেম্বলি) - সমাবেশ [Noun] The school has a morning assembly. [The-স্কুলে school-স্কুল has-আছে a-একটি morning-সকালের assembly-সমাবেশ] (স্কুলে একটি সকালের সমাবেশ আছে।)
- Assert (অ্যাসার্ট) - দাবি করা [Verb] He asserted his innocence. [He-সে asserted-দাবি করেছে his-তার innocence-নিরপরাধিতা] (সে তার নিরপরাধিতা দাবি করেছে।)
- Assess (অ্যাসেস) - মূল্যায়ন করা [Verb] We need to assess the damage. [We-আমাদের need-হবে to-করতে assess-মূল্যায়ন the-ক্ষতি damage-ক্ষতি] (আমাদের ক্ষতি মূল্যায়ন করতে হবে।)
- Assessment (অ্যাসেসমেন্ট) - মূল্যায়ন [Noun] The teacher made an assessment of my progress. [The-শিক্ষক teacher-শিক্ষক made-করেছেন an-একটি assessment-মূল্যায়ন of-এর my-আমার progress-অগ্রগতির] (শিক্ষক আমার অগ্রগতির একটি মূল্যায়ন করেছেন।)
- Asset (অ্যাসেট) - সম্পদ [Noun] Her knowledge of languages is a great asset. [Her-তার knowledge-জ্ঞান of-এর languages-ভাষার is-হয় a-একটি great-বড় asset-সম্পদ] (ভাষার জ্ঞান তার একটি বড় সম্পদ।)
- Assign (অ্যাসাইন) - বরাদ্দ করা [Verb] The teacher assigned a project to us. [The-শিক্ষক teacher-শিক্ষক assigned-বরাদ্দ করেছেন a-একটি project-প্রকল্প to-কাছে us-আমাদের] (শিক্ষক আমাদের কাছে একটি প্রকল্প বরাদ্দ করেছেন।)
- Assignment (অ্যাসাইনমেন্ট) - নির্ধারিত কাজ [Noun] I have a lot of assignments to do. [I-আমার have-আছে a-অনেক lot-অনেক of-এর assignments-নির্ধারিত কাজ to-করার do-করার] (আমার অনেক নির্ধারিত কাজ করার আছে।)
- Assist (অ্যাসিস্ট) - সাহায্য করা [Verb] He assisted me in my work. [He-সে assisted-সাহায্য করেছে me-আমাকে in-এ my-আমার work-কাজে] (সে আমার কাজে আমাকে সাহায্য করেছে।)
- Assistance (অ্যাসিস্ট্যান্স) - সাহায্য [Noun] Thank you for your assistance. [Thank-ধন্যবাদ you-তোমাকে for-জন্য your-তোমার assistance-সাহায্যের] (তোমার সাহায্যের জন্য তোমাকে ধন্যবাদ।)
- Assistant (অ্যাসিস্ট্যান্ট) - সহকারী [Noun] I am looking for a personal assistant. [I-আমি am-খুঁজছি looking-খুঁজছি for-জন্য a-একজন personal-ব্যক্তিগত assistant-সহকারী] (আমি একজন ব্যক্তিগত সহকারী খুঁজছি।)
- Associate (অ্যাসোসিয়েট) - সহযোগী [Verb] I don't want to be associated with him. [I-আমি don't-চাই না want-চাই to-হতে be-হতে associated-সম্পর্কিত with-সাথে him-তার] (আমি তার সাথে সম্পর্কিত হতে চাই না।)
- Association (অ্যাসোসিয়েশন) - সমিতি [Noun] He is a member of the teachers' association. [He-তিনি is-হন a-একজন member-সদস্য of-এর the-শিক্ষকদের teachers'-শিক্ষক association-সমিতির] (তিনি শিক্ষক সমিতির একজন সদস্য।)
- Assume (অ্যাসিউম) - অনুমান করা [Verb] I assume you know what you are doing. [I-আমি assume-অনুমান করি you-তুমি know-জান what-কি you-তুমি are-করছ doing-করছ] (আমি অনুমান করি তুমি জান তুমি কি করছ।)
- Assumption (অ্যাসাম্পশন) - অনুমান [Noun] Your assumption is incorrect. [Your-তোমার assumption-অনুমান is-হয় incorrect-ভুল] (তোমার অনুমান ভুল।)
- Assure (অ্যাশিওর) - আশ্বাস দেওয়া [Verb] I can assure you that you are safe. [I-আমি can-দিতে পারি assure-আশ্বাস you-তোমাকে that-যে you-তুমি are-আছ safe-নিরাপদ] (আমি তোমাকে আশ্বাস দিতে পারি যে তুমি নিরাপদ আছ।)
- Astonish (অ্যাস্টনিশ) - বিস্মিত করা [Verb] The news will astonish everyone. [The-খবরটি news-খবর will-করবে astonish-বিস্মিত everyone-সবাইকে] (খবরটি সবাইকে বিস্মিত করবে।)
- At (অ্যাট) - এ [Preposition] I will meet you at the station. [I-আমি will-করব meet-দেখা you-তোমার সাথে at-এ the-স্টেশনে station-স্টেশন] (আমি তোমার সাথে স্টেশনে দেখা করব।)
- Athlete (অ্যাথলিট) - ক্রীড়াবিদ [Noun] He is a professional athlete. [He-তিনি is-হন a-একজন professional-পেশাদার athlete-ক্রীড়াবিদ] (তিনি একজন পেশাদার ক্রীড়াবিদ।)
- Atmosphere (অ্যাটমোস্ফিয়ার) - বায়ুমণ্ডল [Noun] The Earth's atmosphere is getting polluted. [The-পৃথিবীর Earth's-পৃথিবী atmosphere-বায়ুমণ্ডল is-হচ্ছে getting-হচ্ছে polluted-দূষিত] (পৃথিবীর বায়ুমণ্ডল দূষিত হচ্ছে।)
- Attach (অ্যাটাচ) - সংযুক্ত করা [Verb] I have attached a photo to the email. [I-আমি have-করেছি attached-সংযুক্ত a-একটি photo-ছবি to-সাথে the-ইমেলের email-ইমেল] (আমি ইমেলের সাথে একটি ছবি সংযুক্ত করেছি।)
- Attack (অ্যাটাক) - আক্রমণ [Verb] The enemy attacked at dawn. [The-শত্রু enemy-শত্রু attacked-আক্রমণ করেছিল at-এ dawn-ভোরে] (শত্রু ভোরে আক্রমণ করেছিল।)
- Attempt (অ্যাটেম্পট) - চেষ্টা [Noun] He made an attempt to escape. [He-সে made-করেছিল an-একটি attempt-চেষ্টা to-করার escape-পালানোর] (সে পালানোর একটি চেষ্টা করেছিল।)
- Attend (অ্যাটেন্ড) - উপস্থিত থাকা [Verb] I will attend the meeting. [I-আমি will-থাকব attend-উপস্থিত the-সভায় meeting-সভা] (আমি সভায় উপস্থিত থাকব।)
- Attention (অ্যাটেনশন) - মনোযোগ [Noun] May I have your attention, please? [May-আমি কি I-আমি have-পেতে পারি your-আপনার attention-মনোযোগ, please-দয়া করে] (দয়া করে, আমি কি আপনার মনোযোগ পেতে পারি?)
- Attitude (অ্যাটিটিউড) - মনোভাব [Noun] She has a very positive attitude. [She-তার has-আছে a-একটি very-খুব positive-ইতিবাচক attitude-মনোভাব] (তার একটি খুব ইতিবাচক মনোভাব আছে।)
- Attorney (অ্যাটর্নি) - আইনজীবী [Noun] She is a successful attorney. [She-তিনি is-হন a-একজন successful-সফল attorney-আইনজীবী] (তিনি একজন সফল আইনজীবী।)
- Attract (অ্যাট্রাক্ট) - আকর্ষণ করা [Verb] The flowers attract bees. [The-ফুলগুলো flowers-ফুল attract-আকর্ষণ করে bees-মৌমাছিদের] (ফুলগুলো মৌমাছিদের আকর্ষণ করে।)
- Attraction (অ্যাট্রাকশন) - আকর্ষণ [Noun] The main attraction of the city is the museum. [The-প্রধান main-প্রধান attraction-আকর্ষণ of-এর the-শহরটির city-শহর is-হয় the-জাদুঘর museum-জাদুঘর] (শহরটির প্রধান আকর্ষণ হল জাদুঘর।)
- Attractive (অ্যাট্রাক্টিভ) - আকর্ষণীয় [Adjective] She is a very attractive woman. [She-তিনি is-হন a-একজন very-খুব attractive-আকর্ষণীয় woman-মহিলা] (তিনি একজন খুব আকর্ষণীয় মহিলা।)
- Audience (অডিয়েন্স) - দর্শক [Noun] The audience clapped loudly. [The-দর্শকরা audience-দর্শক clapped-করতালি দিয়েছে loudly-জোরে] (দর্শকরা জোরে করতালি দিয়েছে।)
- August (আগস্ট) - আগস্ট [Noun] My birthday is in August. [My-আমার birthday-জন্মদিন is-হয় in-এ August-আগস্টে] (আমার জন্মদিন আগস্টে।)
- Aunt (আন্ট) - খালা/চাচি/মাসি/পিসি [Noun] My aunt lives in London. [My-আমার aunt-খালা lives-থাকে in-এ London-লন্ডনে] (আমার খালা লন্ডনে থাকে।)
- Author (অথার) - লেখক [Noun] Who is your favorite author? [Who-কে is-হয় your-তোমার favorite-প্রিয় author-লেখক] (তোমার প্রিয় লেখক কে?)
- Authority (অথরিটি) - কর্তৃপক্ষ [Noun] The police have the authority to arrest criminals. [The-পুলিশের police-পুলিশ have-আছে the-কর্তৃত্ব authority-কর্তৃত্ব to-করার arrest-গ্রেপ্তার criminals-অপরাধীদের] (পুলিশের অপরাধীদের গ্রেপ্তার করার কর্তৃত্ব আছে।)
- Automatic (অটোম্যাটিক) - স্বয়ংক্রিয় [Adjective] The doors are automatic. [The-দরজাগুলো doors-দরজা are-হয় automatic-স্বয়ংক্রিয়] (দরজাগুলো স্বয়ংক্রিয়।)
- Available (অ্যাভেইলেবল) - উপলব্ধ [Adjective] Are there any tickets available? [Are-কোন there-সেখানে any-কোন tickets-টিকিট available-উপলব্ধ] (সেখানে কি কোন টিকিট উপলব্ধ আছে?)
- Avenue (অ্যাভিনিউ) - অ্যাভিনিউ [Noun] The hotel is on Fifth Avenue. [The-হোটেলটি hotel-হোটেল is-আছে on-উপর Fifth-পঞ্চম Avenue-অ্যাভিনিউ] (হোটেলটি পঞ্চম অ্যাভিনিউতে আছে।)
- Average (অ্যাভারেজ) - গড় [Adjective] The average age of the students is 20. [The-গড় average-গড় age-বয়স of-এর the-ছাত্রছাত্রীদের students-ছাত্রছাত্রী is-হয় 20-বিশ] (ছাত্রছাত্রীদের গড় বয়স বিশ।)
- Avoid (অ্যাভয়েড) - এড়িয়ে চলা [Verb] You should avoid eating junk food. [You-তোমার should-উচিত avoid-এড়িয়ে চলা eating-খাবার junk-জাঙ্ক food-খাবার] (তোমার জাঙ্ক ফুড খাওয়া এড়িয়ে চলা উচিত।)
- Award (অ্যাওয়ার্ড) - পুরস্কার [Noun] She won an award for her acting. [She-সে won-জিতেছে an-একটি award-পুরস্কার for-জন্য her-তার acting-অভিনয়ের] (সে তার অভিনয়ের জন্য একটি পুরস্কার জিতেছে।)
- Aware (অ্যাওয়ার) - সচেতন [Adjective] Are you aware of the risks? [Are-তুমি কি you-তুমি aware-সচেতন of-এর the-ঝুঁকিগুলোর risks-ঝুঁকি] (তুমি কি ঝুঁকিগুলোর ব্যাপারে সচেতন?)
- Away (অ্যাওয়ে) - দূরে [Adverb] Go away! [Go-যাও away-দূরে] (দূরে যাও!)
- Awful (অফুল) - ভয়ানক [Adjective] The weather is awful today. [The-আবহাওয়া weather-আবহাওয়া is-হয় awful-ভয়ানক today-আজ] (আজ আবহাওয়া ভয়ানক।)
- Awkward (অকোয়ার্ড) - বিশ্রী [Adjective] I felt awkward at the party. [I-আমি felt-অনুভব করছিলাম awkward-বিশ্রী at-এ the-পার্টিতে party-পার্টি] (আমি পার্টিতে বিশ্রী অনুভব করছিলাম।)

- Ball (বল) - বল [Noun] The ball is round. [The-টি ball-বল is-হয় round-গোল] (বলটি গোল।)
- Bat (ব্যাট) - খেলার ব্যাট [Noun] He has a new bat. [He-তার has-আছে a-একটি new-নতুন bat-ব্যাট] (তার একটি নতুন ব্যাট আছে।)
- Box (বক্স) - বাক্স [Noun] The box is heavy. [The-বাক্সটি box-বাক্স is-হয় heavy-ভারী] (বাক্সটি ভারী।)
- Boy (বয়) - ছেলে [Noun] The boy is playing. [The-ছেলেটি boy-ছেলে is-খেলছে playing-খেলছে] (ছেলেটি খেলছে।)
- Book (বুক) - বই [Noun] I am reading a book. [I-আমি am-পড়ছি reading-পড়ছি a-একটি book-বই] (আমি একটি বই পড়ছি।)
- Bag (ব্যাগ) - থলে [Noun] My bag is blue. [My-আমার bag-থলে is-হয় blue-নীল] (আমার থলেটি নীল।)
- Bed (বেড) - বিছানা [Noun] The bed is soft. [The-বিছানাটি bed-বিছানা is-হয় soft-নরম] (বিছানাটি নরম।)
- Bee (বী) - মৌমাছি [Noun] The bee is flying. [The-মৌমাছিটি bee-মৌমাছি is-উড়ছে flying-উড়ছে] (মৌমাছিটি উড়ছে।)
- Bell (বেল) - ঘণ্টা [Noun] The bell is ringing. [The-ঘণ্টাটি bell-ঘণ্টা is-বাজছে ringing-বাজছে] (ঘণ্টাটি বাজছে।)
- Bird (বার্ড) - পাখি [Noun] The bird is singing. [The-পাখিটি bird-পাখি is-গান গাইছে singing-গান গাইছে] (পাখিটি গান গাইছে।)
- Boat (বোট) - নৌকা [Noun] The boat is on the river. [The-নৌকাটি boat-নৌকা is-আছে on-উপর the-নদীর river-নদী] (নৌকাটি নদীর উপর আছে।)
- Body (বডি) - শরীর [Noun] My body is healthy. [My-আমার body-শরীর is-হয় healthy-সুস্থ] (আমার শরীর সুস্থ।)
- Bone (বোন) - হাড় [Noun] The dog has a bone. [The-কুকুরটির dog-কুকুর has-আছে a-একটি bone-হাড়] (কুকুরটির একটি হাড় আছে।)
- Bottle (বটল) - বোতল [Noun] The bottle is full of water. [The-বোতলটি bottle-বোতল is-ভরা full-ভরা of-দিয়ে water-জল] (বোতলটি জল দিয়ে ভরা।)
- Bread (ব্রেড) - রুটি [Noun] I eat bread for breakfast. [I-আমি eat-খাই bread-রুটি for-জন্য breakfast-সকালের নাস্তার] (আমি সকালের নাস্তায় রুটি খাই।)
- Brother (ব্রাদার) - ভাই [Noun] My brother is older than me. [My-আমার brother-ভাই is-হয় older-বড় than-চেয়ে me-আমার] (আমার ভাই আমার চেয়ে বড়।)
- Bus (বাস) - বাস [Noun] I go to school by bus. [I-আমি go-যাই to-স্কুলে school-স্কুল by-বাসে bus-বাস] (আমি বাসে করে স্কুলে যাই।)
- Butterfly (বাটারফ্লাই) - প্রজাপতি [Noun] The butterfly is beautiful. [The-প্রজাপতিটি butterfly-প্রজাপতি is-হয় beautiful-সুন্দর] (প্রজাপতিটি সুন্দর।)
- Baby (বেবি) - শিশু [Noun] The baby is sleeping. [The-শিশুটা baby-শিশু is-ঘুমাচ্ছে sleeping-ঘুমাচ্ছে] (শিশুটা ঘুমাচ্ছে।)
- Back (ব্যাক) - পিঠ [Noun] My back hurts. [My-আমার back-পিঠ hurts-ব্যথা করছে] (আমার পিঠে ব্যথা করছে।)
- Badge (ব্যাজ) - ব্যাজ [Noun] He is wearing a badge. [He-সে is-পরে আছে wearing-পরে আছে a-একটি badge-ব্যাজ] (সে একটি ব্যাজ পরে আছে।)
- Baker (বেকার) - রুটিওয়ালা [Noun] The baker makes bread. [The-রুটিওয়ালা baker-রুটিওয়ালা makes-তৈরি করে bread-রুটি] (রুটিওয়ালা রুটি তৈরি করে।)
- Banana ( ব্যানানা) - কলা [Noun] I like to eat bananas. [I-আমি like-পছন্দ করি to-খেতে eat-খেতে bananas-কলা] (আমি কলা খেতে পছন্দ করি।)
- Band (ব্যান্ড) - দল [Noun] The band is playing music. [The-দলটি band-দল is-বাজাচ্ছে playing-বাজাচ্ছে music-গান] (দলটি গান বাজাচ্ছে।)
- Bank (ব্যাংক) - ব্যাংক [Noun] I am going to the bank. [I-আমি am-যাচ্ছি going-যাচ্ছি to-the-ব্যাংকে bank-ব্যাংক] (আমি ব্যাংকে যাচ্ছি।)
- Barber (বারবার) - নাপিত [Noun] The barber is cutting hair. [The-নাপিত barber-নাপিত is-কাটছে cutting-কাটছে hair-চুল] (নাপিত চুল কাটছে।)
- Barn (বার্ন) - শস্যাগার [Noun] The cows are in the barn. [The-গরুগুলো cows-গরু are-আছে in-the-শস্যাগারে barn-শস্যাগার] (গরুগুলো শস্যাগারে আছে।)
- Basket (বাস্কেট) - ঝুড়ি [Noun] The basket is full of fruits. [The-ঝুড়িটি basket-ঝুড়ি is-ভরা full-ভরা of-দিয়ে fruits-ফল] (ঝুড়িটি ফল দিয়ে ভরা।)
- Bath (বাথ) - স্নান [Noun] I am taking a bath. [I-আমি am-করছি taking-করছি a-একটি bath-স্নান] (আমি স্নান করছি।)
- Beach (বীচ) - সৈকত [Noun] We are going to the beach. [We-আমরা are-যাচ্ছি going-যাচ্ছি to-the-সৈকতে beach-সৈকত] (আমরা সৈকতে যাচ্ছি।)
- Bear (বেয়ার) - ভালুক [Noun] The bear is a big animal. [The-ভালুক bear-ভালুক is-হয় a-একটি big-বড় animal-পশু] (ভালুক একটি বড় পশু।)
- Beard (বেয়ার্ড) - দাড়ি [Noun] He has a long beard. [He-তার has-আছে a-একটি long-লম্বা beard-দাড়ি] (তার একটি লম্বা দাড়ি আছে।)
- Beautiful (বিউটিফুল) - সুন্দর [Adjective] The flower is beautiful. [The-ফুলটি flower-ফুল is-হয় beautiful-সুন্দর] (ফুলটি সুন্দর।)
- Because (বিকজ) - কারণ [Conjunction] I am happy because I won. [I-আমি am-খুশি happy-খুশি because-কারণ I-আমি won-জিতেছি] (আমি খুশি কারণ আমি জিতেছি।)
- Become (বিকাম) - হওয়া [Verb] I want to become a doctor. [I-আমি want-চাই to-হতে become-হতে a-একজন doctor-ডাক্তার] (আমি একজন ডাক্তার হতে চাই।)
- Before (বিফোর) - আগে [Preposition] Wash your hands before eating. [Wash-ধোও your-তোমার hands-হাত before-আগে eating-খাওয়ার] (খাওয়ার আগে তোমার হাত ধোও।)
- Begin (বিগিন) - শুরু করা [Verb] Let's begin the class. [Let's-চলুন begin-শুরু করি the-ক্লাসটি class-ক্লাস] (চলুন ক্লাসটি শুরু করি।)
- Behind (বিহাইন্ড) - পিছনে [Preposition] The cat is behind the door. [The-বিড়ালটি cat-বিড়াল is-আছে behind-পিছনে the-দরজার door-দরজা] (বিড়ালটি দরজার পিছনে আছে।)
- Believe (বিলিভ) - বিশ্বাস করা [Verb] I believe you. [I-আমি believe-বিশ্বাস করি you-তোমাকে] (আমি তোমাকে বিশ্বাস করি।)
- Below (বিলো) - নিচে [Preposition] The ball is below the table. [The-বলটি ball-বল is-আছে below-নিচে the-টেবিলের table-টেবিল] (বলটি টেবিলের নিচে আছে।)
- Belt (বেল্ট) - বেল্ট [Noun] He is wearing a belt. [He-সে is-পরে আছে wearing-পরে আছে a-একটি belt-বেল্ট] (সে একটি বেল্ট পরে আছে।)
- Bench (বেঞ্চ) - বেঞ্চ [Noun] We are sitting on a bench. [We-আমরা are-বসে আছি sitting-বসে আছি on-উপর a-একটি bench-বেঞ্চে] (আমরা একটি বেঞ্চে বসে আছি।)
- Bend (বেন্ড) - বাঁকানো [Verb] Can you bend this stick? [Can-তুমি কি you-তুমি bend-বাঁকাতে পারো this-এই stick-লাঠিটি] (তুমি কি এই লাঠিটি বাঁকাতে পারো?)
- Beside (বিসাইড) - পাশে [Preposition] He is sitting beside me. [He-সে is-বসে আছে sitting-বসে আছে beside-পাশে me-আমার] (সে আমার পাশে বসে আছে।)
- Best (বেস্ট) - সেরা [Adjective] He is my best friend. [He-সে is-হয় my-আমার best-সেরা friend-বন্ধু] (সে আমার সেরা বন্ধু।)
- Better (বেটার) - আরও ভালো [Adjective] This one is better than that one. [This-এটা one-এটা is-হয় better-আরও ভালো than-চেয়ে that-ওটা one-ওটা] (এটা ওটার চেয়ে আরও ভালো।)
- Between (বিটুইন) - মধ্যে [Preposition] The book is between the two bags. [The-বইটি book-বই is-আছে between-মধ্যে the-দুটি two-দুটি bags-ব্যাগের] (বইটি দুটি ব্যাগের মধ্যে আছে।)
- Bicycle (বাইসাইকেল) - সাইকেল [Noun] I have a new bicycle. [I-আমার have-আছে a-একটি new-নতুন bicycle-সাইকেল] (আমার একটি নতুন সাইকেল আছে।)
- Big (বিগ) - বড় [Adjective] The elephant is a big animal. [The-হাতি elephant-হাতি is-হয় a-একটি big-বড় animal-পশু] (হাতি একটি বড় পশু।)
- Bike (বাইক) - বাইক [Noun] He is riding a bike. [He-সে is-চালাচ্ছে riding-চালাচ্ছে a-একটি bike-বাইক] (সে একটি বাইক চালাচ্ছে।)
- Bill (বিল) - বিল [Noun] I have to pay the bill. [I-আমাকে have-করতে হবে to-দিতে pay-দিতে the-বিলটি bill-বিল] (আমাকে বিলটি দিতে হবে।)
- Billion (বিলিয়ন) - একশ কোটি [Noun] There are billions of stars in the sky. [There-সেখানে are-আছে billions-একশ কোটি of-এর stars-তারা in-the-আকাশে sky-আকাশ] (আকাশে একশ কোটি তারা আছে।)
- Bin (বিন) - ময়লার ঝুড়ি [Noun] Throw it in the bin. [Throw-ফেল it-এটা in-the-ময়লার ঝুড়িতে bin-ময়লার ঝুড়ি] (এটা ময়লার ঝুড়িতে ফেল।)
- Bind (বাইন্ড) - বাঁধা [Verb] Please bind these papers together. [Please-দয়া করে bind-বাঁধুন these-এই papers-কাগজগুলো together-একসাথে] (দয়া করে এই কাগজগুলো একসাথে বাঁধুন।)
- Biography (বায়োগ্রাফি) - জীবনী [Noun] I am reading a biography of a famous person. [I-আমি am-পড়ছি reading-পড়ছি a-একটি biography-জীবনী of-এর a-একজন famous-বিখ্যাত person-ব্যক্তির] (আমি একজন বিখ্যাত ব্যক্তির জীবনী পড়ছি।)
- Birthday (বার্থডে) - জন্মদিন [Noun] Today is my birthday. [Today-আজ is-হয় my-আমার birthday-জন্মদিন] (আজ আমার জন্মদিন।)
- Bite (বাইট) - কামড়ানো [Verb] The dog might bite you. [The-কুকুরটি dog-কুকুর might-কামড়াতে পারে bite-কামড়াতে you-তোমাকে] (কুকুরটি তোমাকে কামড়াতে পারে।)
- Bitter (বিটার) - তিক্ত [Adjective] The medicine tastes bitter. [The-ঔষধটি medicine-ঔষধ tastes-স্বাদে bitter-তিক্ত] (ঔষধটির স্বাদ তিক্ত।)
- Black (ব্ল্যাক) - কালো [Adjective] The cat is black. [The-বিড়ালটি cat-বিড়াল is-হয় black-কালো] (বিড়ালটি কালো।)
- Blade (ব্লেড) - ব্লেড [Noun] The knife has a sharp blade. [The-ছুরিটির knife-ছুরি has-আছে a-একটি sharp-ধারালো blade-ব্লেড] (ছুরিটির একটি ধারালো ব্লেড আছে।)
- Blame (ব্লেম) - দোষ দেওয়া [Verb] Don't blame me for your mistake. [Don't-দিও না blame-দোষ me-আমাকে for-জন্য your-তোমার mistake-ভুলের] (তোমার ভুলের জন্য আমাকে দোষ দিও না।)
- Blanket (ব্ল্যাঙ্কেট) - কম্বল [Noun] I need a blanket. [I-আমার need-দরকার a-একটি blanket-কম্বল] (আমার একটি কম্বল দরকার।)
- Bleed (ব্লীড) - রক্তপাত হওয়া [Verb] My finger is bleeding. [My-আমার finger-আঙুল is-হচ্ছে bleeding-রক্তপাত] (আমার আঙুল থেকে রক্তপাত হচ্ছে।)
- Blend (ব্লেন্ড) - মেশানো [Verb] Blend the fruits to make a smoothie. [Blend-মেশাও the-ফলগুলো fruits-ফল to-বানাতে make-বানাতে a-একটি smoothie-স্মুদি] (স্মুদি বানাতে ফলগুলো মেশাও।)
- Bless (ব্লেস) - আশীর্বাদ করা [Verb] May God bless you. [May-করুন God-ঈশ্বর bless-আশীর্বাদ you-তোমাকে] (ঈশ্বর তোমাকে আশীর্বাদ করুন।)
- Blind (ব্লাইন্ড) - অন্ধ [Adjective] He is blind in one eye. [He-সে is-হয় blind-অন্ধ in-এক one-এক eye-চোখে] (সে এক চোখে অন্ধ।)
- Block (ব্লক) - ব্লক [Noun] The road is blocked. [The-রাস্তাটি road-রাস্তা is-বন্ধ blocked-বন্ধ] (রাস্তাটি বন্ধ।)
- Blood (ব্লাড) - রক্ত [Noun] Blood is red. [Blood-রক্ত is-হয় red-লাল] (রক্ত লাল।)
- Bloom (ব্লুম) - ফোটা [Verb] The flowers are blooming. [The-ফুলগুলো flowers-ফুল are-ফুটছে blooming-ফুটছে] (ফুলগুলো ফুটছে।)
- Blow (ব্লো) - ফুঁ দেওয়া [Verb] Blow out the candles. [Blow-ফুঁ দাও out-নিভিয়ে the-মোমবাতিগুলো candles-মোমবাতি] (মোমবাতিগুলো ফুঁ দিয়ে নিভিয়ে দাও।)
- Blue (ব্লু) - নীল [Adjective] The sky is blue. [The-আকাশ sky-আকাশ is-হয় blue-নীল] (আকাশ নীল।)
- Board (বোর্ড) - বোর্ড [Noun] The teacher is writing on the board. [The-শিক্ষক teacher-শিক্ষক is-লিখছেন writing-লিখছেন on-the-বোর্ডে board-বোর্ড] (শিক্ষক বোর্ডে লিখছেন।)
- Boil (বয়েল) - সিদ্ধ করা [Verb] Please boil the water. [Please-দয়া করে boil-সিদ্ধ করুন the-জল water-জল] (দয়া করে জল সিদ্ধ করুন।)
- Bold (বোল্ড) - সাহসী [Adjective] He is a bold leader. [He-তিনি is-হন a-একজন bold-সাহসী leader-নেতা] (তিনি একজন সাহসী নেতা।)
- Bomb (বম) - বোমা [Noun] A bomb exploded in the city. [A-একটি bomb-বোমা exploded-বিস্ফোরিত হয়েছে in-the-শহরে city-শহর] (শহরে একটি বোমা বিস্ফোরিত হয়েছে।)
- Bond (বন্ড) - বন্ধন [Noun] They have a strong bond of friendship. [They-তাদের have-আছে a-একটি strong-দৃঢ় bond-বন্ধন of-এর friendship-বন্ধুত্বের] (তাদের বন্ধুত্বের একটি দৃঢ় বন্ধন আছে।)
- Bonus (বোনাস) - বোনাস [Noun] I received a bonus from my company. [I-আমি received-পেয়েছি a-একটি bonus-বোনাস from-থেকে my-আমার company-কোম্পানির] (আমি আমার কোম্পানির থেকে একটি বোনাস পেয়েছি।)
- Border (বর্ডার) - সীমানা [Noun] We are near the border. [We-আমরা are-আছি near-কাছে the-সীমানার border-সীমানা] (আমরা সীমানার কাছে আছি।)
- Boring (বোরিং) - বিরক্তিকর [Adjective] The movie was boring. [The-চলচ্চিত্রটি movie-চলচ্চিত্র was-ছিল boring-বিরক্তিকর] (চলচ্চিত্রটি বিরক্তিকর ছিল।)
- Born (বর্ন) - জন্মগ্রহণ করা [Verb] I was born in this city. [I-আমি was-জন্মেছিলাম born-জন্মেছিলাম in-this-এই city-শহরে] (আমি এই শহরে জন্মেছিলাম।)
- Borrow (বরো) - ধার করা [Verb] Can I borrow your pen? [Can-আমি কি I-আমি borrow-ধার করতে পারি your-তোমার pen-কলম] (আমি কি তোমার কলম ধার করতে পারি?)
- Boss (বস) - বস [Noun] My boss is very strict. [My-আমার boss-বস is-হয় very-খুব strict-কঠোর] (আমার বস খুব কঠোর।)
- Both (বোথ) - উভয় [Determiner] Both of them are my friends. [Both-উভয় of-এর them-তারা are-হয় my-আমার friends-বন্ধু] (তারা উভয়ই আমার বন্ধু।)
- Bother (বদার) - বিরক্ত করা [Verb] Don't bother me. [Don't-করো না bother-বিরক্ত me-আমাকে] (আমাকে বিরক্ত করো না।)
- Bottom (বটম) - নীচে [Noun] The keys are at the bottom of the bag. [The-চাবিগুলো keys-চাবি are-আছে at-the-নীচে bottom-নীচে of-এর the-ব্যাগের bag-ব্যাগ] (চাবিগুলো ব্যাগের নীচে আছে।)
- Bounce (বাউন্স) - লাফানো [Verb] The ball is bouncing. [The-বলটি ball-বল is-লাফাচ্ছে bouncing-লাফাচ্ছে] (বলটি লাফাচ্ছে।)
- Bow (বো) - ধনুক [Noun] He has a bow and arrow. [He-তার has-আছে a-একটি bow-ধনুক and-এবং arrow-তীর] (তার একটি ধনুক এবং তীর আছে।)
- Bowl (বোল) - বাটি [Noun] I need a bowl of soup. [I-আমার need-দরকার a-একটি bowl-বাটি of-এর soup-স্যুপ] (আমার এক বাটি স্যুপ দরকার।)
- Brain (ব্রেইন) - মস্তিষ্ক [Noun] The brain is a very important organ. [The-মস্তিষ্ক brain-মস্তিষ্ক is-হয় a-একটি very-খুব important-গুরুত্বপূর্ণ organ-অঙ্গ] (মস্তিষ্ক একটি খুব গুরুত্বপূর্ণ অঙ্গ।)
- Branch (ব্রাঞ্চ) - শাখা [Noun] The bird is sitting on a branch. [The-পাখিটি bird-পাখি is-বসে আছে sitting-বসে আছে on-a-একটি branch-শাখায়] (পাখিটি একটি শাখায় বসে আছে।)
- Brave (ব্রেভ) - সাহসী [Adjective] He is a brave soldier. [He-সে is-হয় a-একজন brave-সাহসী soldier-সৈনিক] (সে একজন সাহসী সৈনিক।)
- Break (ব্রেক) - ভাঙ্গা [Verb] Be careful, don't break the glass. [Be-থাকুন careful-সতর্ক, don't-ভাঙ্গবেন না break-ভাঙ্গবেন the-গ্লাসটি glass-গ্লাস] (সতর্ক থাকুন, গ্লাসটি ভাঙ্গবেন না।)
- Breakfast (ব্রেকফাস্ট) - সকালের নাস্তা [Noun] What did you have for breakfast? [What-কি did-খেয়েছ you-তুমি have-খেয়েছ for-জন্য breakfast-সকালের নাস্তায়] (তুমি সকালের নাস্তায় কি খেয়েছ?)
- Breath (ব্রেথ) - শ্বাস [Noun] Take a deep breath. [Take-নাও a-একটি deep-গভীর breath-শ্বাস] (একটি গভীর শ্বাস নাও।)
- Breathe (ব্রীদ) - শ্বাস নেওয়া [Verb] I can't breathe properly. [I-আমি can't-পারছি না breathe-শ্বাস নিতে properly-সঠিকভাবে] (আমি সঠিকভাবে শ্বাস নিতে পারছি না।)
- Brick (ব্রিক) - ইট [Noun] The house is made of bricks. [The-বাড়িটি house-বাড়ি is-তৈরি made-তৈরি of-দিয়ে bricks-ইট] (বাড়িটি ইট দিয়ে তৈরি।)
- Bridge (ব্রিজ) - সেতু [Noun] We are crossing a bridge. [We-আমরা are-পার হচ্ছি crossing-পার হচ্ছি a-একটি bridge-সেতু] (আমরা একটি সেতু পার হচ্ছি।)
- Brief (ব্রীফ) - সংক্ষিপ্ত [Adjective] I will give a brief speech. [I-আমি will-দেব give-দেব a-একটি brief-সংক্ষিপ্ত speech-বক্তৃতা] (আমি একটি সংক্ষিপ্ত বক্তৃতা দেব।)
- Bright (ব্রাইট) - উজ্জ্বল [Adjective] The sun is very bright today. [The-সূর্য sun-সূর্য is-হয় very-খুব bright-উজ্জ্বল today-আজ] (আজ সূর্য খুব উজ্জ্বল।)
- Brilliant (ব্রিলিয়ান্ট) - মেধাবী [Adjective] He is a brilliant student. [He-সে is-হয় a-একজন brilliant-মেধাবী student-ছাত্র] (সে একজন মেধাবী ছাত্র।)
- Bring (ব্রিং) - আনা [Verb] Please bring me a glass of water. [Please-দয়া করে bring-আনুন me-আমাকে a-একটি glass-গ্লাস of-এর water-জল] (দয়া করে আমাকে এক গ্লাস জল আনুন।)
- Broad (ব্রড) - প্রশস্ত [Adjective] The road is very broad. [The-রাস্তাটি road-রাস্তা is-হয় very-খুব broad-প্রশস্ত] (রাস্তাটি খুব প্রশস্ত।)
- Broadcast (ব্রডকাস্ট) - সম্প্রচার করা [Verb] The news will be broadcast at 10 pm. [The-খবরটি news-খবর will-হবে be-হবে broadcast-সম্প্রচারিত at-10-দশ pm-রাত] (খবরটি রাত দশটায় সম্প্রচারিত হবে।)
- Broken (ব্রোকেন) - ভাঙ্গা [Adjective] The chair is broken. [The-চেয়ারটি chair-চেয়ার is-হয় broken-ভাঙ্গা] (চেয়ারটি ভাঙ্গা।)
- Broom (ব্রুম) - ঝাড়ু [Noun] I need a broom to clean the floor. [I-আমার need-দরকার a-একটি broom-ঝাড়ু to-পরিষ্কার করতে clean-পরিষ্কার করতে the-মেঝে floor-মেঝে] (আমার মেঝে পরিষ্কার করতে একটি ঝাড়ু দরকার।)
- Brush (ব্রাশ) - ব্রাশ [Noun] I need a new toothbrush. [I-আমার need-দরকার a-একটি new-নতুন toothbrush-টুথব্রাশ] (আমার একটি নতুন টুথব্রাশ দরকার।)
- Bubble (বাবল) - বুদবুদ [Noun] The child is playing with bubbles. [The-শিশুটা child-শিশু is-খেলছে playing-খেলছে with-দিয়ে bubbles-বুদবুদ] (শিশুটা বুদবুদ দিয়ে খেলছে।)
- Bucket (বাকেট) - বালতি [Noun] The bucket is full of water. [The-বালতিটি bucket-বালতি is-ভরা full-ভরা of-দিয়ে water-জল] (বালতিটি জল দিয়ে ভরা।)
- Bud (বাড) - কুঁড়ি [Noun] The rose bud is about to bloom. [The-গোলাপের rose-গোলাপ bud-কুঁড়ি is-ফুটতে চলেছে about-প্রায় to-ফুটতে bloom-ফুটতে] (গোলাপের কুঁড়ি ফুটতে চলেছে।)
- Budget (বাজেট) - বাজেট [Noun] We need to plan our budget. [We-আমাদের need-দরকার to-পরিকল্পনা করতে plan-পরিকল্পনা করতে our-আমাদের budget-বাজেট] (আমাদের বাজেট পরিকল্পনা করতে হবে।)
- Bug (বাগ) - পোকা [Noun] There is a bug on the wall. [There-সেখানে is-আছে a-একটি bug-পোকা on-the-দেয়ালে wall-দেয়াল] (দেয়ালে একটি পোকা আছে।)
- Build (বিল্ড) - নির্মাণ করা [Verb] They are building a new house. [They-তারা are-নির্মাণ করছে building-নির্মাণ করছে a-একটি new-নতুন house-বাড়ি] (তারা একটি নতুন বাড়ি নির্মাণ করছে।)
- Building (বিল্ডিং) - ভবন [Noun] This is a very tall building. [This-এটা is-হয় a-একটি very-খুব tall-লম্বা building-ভবন] (এটা একটি খুব লম্বা ভবন।)
- Bulb (বাল্ব) - বাল্ব [Noun] The light bulb is not working. [The-আলোর light-আলো bulb-বাল্ব is-কাজ করছে না not-না working-কাজ করছে] (আলোর বাল্ব কাজ করছে না।)
- Bull (বুল) - ষাঁড় [Noun] The bull is very strong. [The-ষাঁড় bull-ষাঁড় is-হয় very-খুব strong-শক্তিশালী] (ষাঁড় খুব শক্তিশালী।)
- Bullet (বুলেট) - গুলি [Noun] The gun was loaded with bullets. [The-বন্দুকটি gun-বন্দুক was-ভরা ছিল loaded-ভরা with-দিয়ে bullets-গুলি] (বন্দুকটি গুলি দিয়ে ভরা ছিল।)
- Bunch (বাঞ্চ) - গোছা [Noun] I bought a bunch of bananas. [I-আমি bought-কিনেছি a-একটি bunch-গোছা of-এর bananas-কলার] (আমি এক গোছা কলা কিনেছি।)
- Burden (বার্ডেন) - বোঝা [Noun] I don't want to be a burden to you. [I-আমি don't-চাই না want-চাই to-হতে be-হতে a-একটি burden-বোঝা to-তোমার জন্য you-তোমার] (আমি তোমার জন্য বোঝা হতে চাই না।)
- Burn (বার্ন) - পোড়ানো [Verb] Be careful, you might burn yourself. [Be-থাকুন careful-সতর্ক, you-তুমি might-পুড়তে পারো burn-পুড়তে yourself-নিজেকে] (সতর্ক থাকুন, তুমি নিজেকে পুড়তে পারো।)
- Burst (বার্স্ট) - ফেটে যাওয়া [Verb] The balloon burst. [The-বেলুনটি balloon-বেলুন burst-ফেটে গেল] (বেলুনটি ফেটে গেল।)
- Bury (বেরি) - কবর দেওয়া [Verb] They will bury him tomorrow. [They-তারা will-কবর দেবে bury-কবর দেবে him-তাকে tomorrow-আগামীকাল] (তারা তাকে আগামীকাল কবর দেবে।)
- Bush (বুশ) - ঝোপ [Noun] The cat is hiding in the bush. [The-বিড়ালটি cat-বিড়াল is-লুকিয়ে আছে hiding-লুকিয়ে আছে in-the-ঝোপে bush-ঝোপ] (বিড়ালটি ঝোপে লুকিয়ে আছে।)
- Business (বিজনেস) - ব্যবসা [Noun] He has his own business. [He-তার has-আছে his-নিজের own-নিজের business-ব্যবসা] (তার নিজের ব্যবসা আছে।)
- Busy (বিজি) - ব্যস্ত [Adjective] I am very busy today. [I-আমি am-খুব busy-ব্যস্ত today-আজ] (আমি আজ খুব ব্যস্ত।)
- But (বাট) - কিন্তু [Conjunction] I want to go, but I can't. [I-আমি want-চাই to-যেতে go-যেতে, but-কিন্তু I-আমি can't-পারব না] (আমি যেতে চাই, কিন্তু আমি পারব না।)
- Butcher (বুচার) - কসাই [Noun] The butcher sells meat. [The-কসাই butcher-কসাই sells-বিক্রি করে meat-মাংস] (কসাই মাংস বিক্রি করে।)
- Butter (বাটার) - মাখন [Noun] I like butter on my bread. [I-আমি like-পছন্দ করি butter-মাখন on-my-আমার bread-রুটিতে] (আমি আমার রুটিতে মাখন পছন্দ করি।)
- Button (বাটন) - বোতাম [Noun] One of the buttons on my shirt is missing. [One-একটি of-এর the-বোতামগুলোর buttons-বোতাম on-my-আমার shirt-শার্টের is-নেই missing-নেই] (আমার শার্টের একটি বোতাম নেই।)
- Buy (বাই) - কেনা [Verb] I want to buy a new dress. [I-আমি want-চাই to-কিনতে buy-কিনতে a-একটি new-নতুন dress-পোশাক] (আমি একটি নতুন পোশাক কিনতে চাই।)
- By (বাই) - দ্বারা [Preposition] The book was written by a famous author. [The-বইটি book-বই was-লেখা হয়েছিল written-লেখা হয়েছিল by-দ্বারা a-একজন famous-বিখ্যাত author-লেখকের] (বইটি একজন বিখ্যাত লেখকের দ্বারা লেখা হয়েছিল।)
- Bye (বাই) - বিদায় [Interjection] Bye, see you tomorrow. [Bye-বিদায়, see-দেখা হবে you-তোমার সাথে tomorrow-আগামীকাল] (বিদায়, তোমার সাথে আগামীকাল দেখা হবে।)
- Cabin (কেবিন) - কেবিন [Noun] We are staying in a cabin in the woods. [We-আমরা are-থাকছি staying-থাকছি in-a-একটি cabin-কেবিনে in-the-বনে woods-বন] (আমরা বনের মধ্যে একটি কেবিনে থাকছি।)
- Cabinet (ক্যাবিনেট) - মন্ত্রিসভা [Noun] The cabinet will meet tomorrow. [The-মন্ত্রিসভা cabinet-মন্ত্রিসভা will-মিলিত হবে meet-মিলিত হবে tomorrow-আগামীকাল] (মন্ত্রিসভা আগামীকাল মিলিত হবে।)
- Cable (কেবল) - তার [Noun] The TV is not working because the cable is loose. [The-টিভি TV-টিভি is-কাজ করছে না not-না working-কাজ করছে because-কারণ the-তারটি cable-তার is-আলগা loose-আলগা] (টিভি কাজ করছে না কারণ তারটি আলগা।)
- Cage (কেজ) - খাঁচা [Noun] The bird is in the cage. [The-পাখিটি bird-পাখি is-আছে in-the-খাঁচায় cage-খাঁচা] (পাখিটি খাঁচায় আছে।)
- Cake (কেক) - কেক [Noun] I love to eat chocolate cake. [I-আমি love-ভালোবাসি to-খেতে eat-খেতে chocolate-চকলেট cake-কেক] (আমি চকলেট কেক খেতে ভালোবাসি।)
- Calculate (ক্যালকুলেট) - গণনা করা [Verb] Can you calculate the total cost? [Can-তুমি কি you-তুমি calculate-গণনা করতে পারো the-মোট total-মোট cost-খরচ] (তুমি কি মোট খরচ গণনা করতে পারো?)
- Calendar (ক্যালেন্ডার) - ক্যালেন্ডার [Noun] I have marked the date on the calendar. [I-আমি have-চিহ্নিত করেছি marked-চিহ্নিত করেছি the-তারিখটি date-তারিখ on-the-ক্যালেন্ডারে calendar-ক্যালেন্ডার] (আমি ক্যালেন্ডারে তারিখটি চিহ্নিত করেছি।)
- Call (কল) - ডাকা [Verb] Please call me when you are free. [Please-দয়া করে call-ফোন করো me-আমাকে when-যখন you-তুমি are-থাকবে free-অবসর] (দয়া করে যখন তুমি অবসর থাকবে তখন আমাকে ফোন করো।)
- Calm (কাম) - শান্ত [Adjective] The sea is very calm today. [The-সমুদ্র sea-সমুদ্র is-হয় very-খুব calm-শান্ত today-আজ] (আজ সমুদ্র খুব শান্ত।)
- Camel (ক্যামেল) - উট [Noun] The camel is known as the ship of the desert. [The-উট camel-উট is-পরিচিত known-পরিচিত as-হিসাবে the-জাহাজ ship-জাহাজ of-এর the-মরুভূমির desert-মরুভূমি] (উট মরুভূমির জাহাজ হিসাবে পরিচিত।)
- Camera (ক্যামেরা) - ক্যামেরা [Noun] I have a new camera. [I-আমার have-আছে a-একটি new-নতুন camera-ক্যামেরা] (আমার একটি নতুন ক্যামেরা আছে।)
- Camp (ক্যাম্প) - শিবির [Noun] We are going on a camping trip. [We-আমরা are-যাচ্ছি going-যাচ্ছি on-a-একটি camping-ক্যাম্পিং trip-ভ্রমণে] (আমরা একটি ক্যাম্পিং ভ্রমণে যাচ্ছি।)
- Campaign (ক্যাম্পেইন) - প্রচারণা [Noun] They have launched a new advertising campaign. [They-তারা have-চালু করেছে launched-চালু করেছে a-একটি new-নতুন advertising-বিজ্ঞাপন campaign-প্রচারণা] (তারা একটি নতুন বিজ্ঞাপন প্রচারণা চালু করেছে।)
- Can (ক্যান) - পারা [Verb] I can swim. [I-আমি can-পারি swim-সাঁতার কাটতে] (আমি সাঁতার কাটতে পারি।)
- Cancel (ক্যানসেল) - বাতিল করা [Verb] I have to cancel my appointment. [I-আমাকে have-করতে হবে to-বাতিল করতে cancel-বাতিল করতে my-আমার appointment-সাক্ষাৎ] (আমাকে আমার সাক্ষাৎ বাতিল করতে হবে।)
- Cancer (ক্যান্সার) - ক্যান্সার [Noun] He is suffering from cancer. [He-তিনি is-ভুগছেন suffering-ভুগছেন from-থেকে cancer-ক্যান্সারে] (তিনি ক্যান্সারে ভুগছেন।)
- Candidate (ক্যান্ডিডেট) - প্রার্থী [Noun] He is a candidate for the election. [He-তিনি is-হন a-একজন candidate-প্রার্থী for-জন্য the-নির্বাচনের election-নির্বাচন] (তিনি নির্বাচনের জন্য একজন প্রার্থী।)
- Candle (ক্যান্ডেল) - মোমবাতি [Noun] The room was lit by a single candle. [The-ঘরটি room-ঘর was-আলোকিত ছিল lit-আলোকিত by-দ্বারা a-একটি single-একক candle-মোমবাতির] (ঘরটি একটি একক মোমবাতির দ্বারা আলোকিত ছিল।)
- Candy (ক্যান্ডি) - ক্যান্ডি [Noun] I like to eat candy. [I-আমি like-পছন্দ করি to-খেতে eat-খেতে candy-ক্যান্ডি] (আমি ক্যান্ডি খেতে পছন্দ করি।)
- Cap (ক্যাপ) - টুপি [Noun] He is wearing a cap. [He-সে is-পরে আছে wearing-পরে আছে a-একটি cap-টুপি] (সে একটি টুপি পরে আছে।)
- Capable (কেপেবল) - সক্ষম [Adjective] He is capable of doing the job. [He-সে is-হয় capable-সক্ষম of-করতে doing-করতে the-কাজটি job-কাজ] (সে কাজটি করতে সক্ষম।)
- Capacity (ক্যাপাসিটি) - ক্ষমতা [Noun] The hall has a seating capacity of 500 people. [The-হলটির hall-হল has-আছে a-একটি seating-বসার capacity-ক্ষমতা of-এর 500-পাঁচশ people-লোকের] (হলটির পাঁচশ লোকের বসার ক্ষমতা আছে।)
- Capital (ক্যাপিটাল) - রাজধানী [Noun] Dhaka is the capital of Bangladesh. [Dhaka-ঢাকা is-হয় the-রাজধানী capital-রাজধানী of-এর Bangladesh-বাংলাদেশের] (ঢাকা বাংলাদেশের রাজধানী।)
- Captain (ক্যাপ্টেন) - অধিনায়ক [Noun] He is the captain of the team. [He-সে is-হয় the-অধিনায়ক captain-অধিনায়ক of-এর the-দলটির team-দল] (সে দলটির অধিনায়ক।)
- Capture (ক্যাপচার) - ধরা [Verb] The police captured the thief. [The-পুলিশ police-পুলিশ captured-ধরেছে the-চোরটিকে thief-চোর] (পুলিশ চোরটিকে ধরেছে।)
- Car (কার) - গাড়ি [Noun] I have a new car. [I-আমার have-আছে a-একটি new-নতুন car-গাড়ি] (আমার একটি নতুন গাড়ি আছে।)
- Card (কার্ড) - কার্ড [Noun] I have a credit card. [I-আমার have-আছে a-একটি credit-ক্রেডিট card-কার্ড] (আমার একটি ক্রেডিট কার্ড আছে।)
- Care (কেয়ার) - যত্ন [Noun] Take care of yourself. [Take-নাও care-যত্ন of-এর yourself-তোমার নিজের] (তোমার নিজের যত্ন নাও।)
- Career (ক্যারিয়ার) - কর্মজীবন [Noun] I want to have a successful career. [I-আমি want-চাই to-গড়তে have-গড়তে a-একটি successful-সফল career-কর্মজীবন] (আমি একটি সফল কর্মজীবন গড়তে চাই।)
- Careful (কেয়ারফুল) - সতর্ক [Adjective] Be careful while crossing the road. [Be-থাকুন careful-সতর্ক while-যখন crossing-পার হচ্ছেন the-রাস্তা road-রাস্তা] (রাস্তা পার হওয়ার সময় সতর্ক থাকুন।)
- Careless (কেয়ারলেস) - অসতর্ক [Adjective] He is very careless. [He-সে is-হয় very-খুব careless-অসতর্ক] (সে খুব অসতর্ক।)
- Cargo (কার্গো) - পণ্য [Noun] The ship is carrying a lot of cargo. [The-জাহাজটি ship-জাহাজ is-বহন করছে carrying-বহন করছে a-অনেক lot-অনেক of-এর cargo-পণ্য] (জাহাজটি অনেক পণ্য বহন করছে।)
- Carpenter (কার্পেন্টার) - ছুতার [Noun] The carpenter is making a table. [The-ছুতার carpenter-ছুতার is-তৈরি করছে making-তৈরি করছে a-একটি table-টেবিল] (ছুতার একটি টেবিল তৈরি করছে।)
- Carpet (কার্পেট) - গালিচা [Noun] The floor is covered with a carpet. [The-মেঝে floor-মেঝে is-ঢাকা covered-ঢাকা with-দিয়ে a-একটি carpet-গালিচা] (মেঝে একটি গালিচা দিয়ে ঢাকা।)
- Carrot (ক্যারট) - গাজর [Noun] I like to eat carrots. [I-আমি like-পছন্দ করি to-খেতে eat-খেতে carrots-গাজর] (আমি গাজর খেতে পছন্দ করি।)
- Carry (ক্যারি) - বহন করা [Verb] Can you carry this bag for me? [Can-তুমি কি you-তুমি carry-বহন করতে পারো this-এই bag-ব্যাগটি for-জন্য me-আমার] (তুমি কি আমার জন্য এই ব্যাগটি বহন করতে পারো?)
- Case (কেস) - মামলা [Noun] The police are investigating the case. [The-পুলিশ police-পুলিশ are-তদন্ত করছে investigating-তদন্ত করছে the-মামলাটি case-মামলা] (পুলিশ মামলাটি তদন্ত করছে।)
- Cash (ক্যাশ) - নগদ [Noun] I have no cash with me. [I-আমার have-নেই no-নেই cash-নগদ with-সাথে me-আমার] (আমার সাথে নগদ নেই।)
- Cast (কাস্ট) - নিক্ষেপ করা [Verb] He cast a stone into the river. [He-সে cast-নিক্ষেপ করেছে a-একটি stone-পাথর into-the-নদীতে river-নদী] (সে নদীতে একটি পাথর নিক্ষেপ করেছে।)
- Castle (ক্যাসেল) - দুর্গ [Noun] The king lives in a castle. [The-রাজা king-রাজা lives-থাকে in-a-একটি castle-দুর্গে] (রাজা একটি দুর্গে থাকে।)
- Cat (ক্যাট) - বিড়াল [Noun] The cat is sleeping on the mat. [The-বিড়ালটি cat-বিড়াল is-ঘুমাচ্ছে sleeping-ঘুমাচ্ছে on-the-মাদুরের উপর mat-মাদুর] (বিড়ালটি মাদুরের উপর ঘুমাচ্ছে।)
- Catch (ক্যাচ) - ধরা [Verb] Can you catch the ball? [Can-তুমি কি you-তুমি catch-ধরতে পারো the-বলটি ball-বল] (তুমি কি বলটি ধরতে পারো?)
- Category (ক্যাটাগরি) - বিভাগ [Noun] The books are arranged in different categories. [The-বইগুলো books-বই are-সাজানো আছে arranged-সাজানো আছে in-different-বিভিন্ন categories-বিভাগে] (বইগুলো বিভিন্ন বিভাগে সাজানো আছে।)
- Cattle (ক্যাটল) - গবাদি পশু [Noun] The cattle are grazing in the field. [The-গবাদি পশু cattle-গবাদি পশু are-চরছে grazing-চরছে in-the-মাঠে field-মাঠ] (গবাদি পশু মাঠে চরছে।)
- Cause (কজ) - কারণ [Noun] What was the cause of the accident? [What-কি was-ছিল the-কারণ cause-কারণ of-এর the-দুর্ঘটনার accident-দুর্ঘটনা] (দুর্ঘটনার কারণ কি ছিল?)
- Cease (সীজ) - থামা [Verb] The rain has ceased. [The-বৃষ্টি rain-বৃষ্টি has-থেমে গেছে ceased-থেমে গেছে] (বৃষ্টি থেমে গেছে।)
- Ceiling (সিলিং) - ছাদ [Noun] The fan is hanging from the ceiling. [The-পাখাটি fan-পাখা is-ঝুলছে hanging-ঝুলছে from-the-ছাদ থেকে ceiling-ছাদ] (পাখাটি ছাদ থেকে ঝুলছে।)
- Celebrate (সেলিব্রেট) - উদযাপন করা [Verb] We are going to celebrate his birthday. [We-আমরা are-করতে যাচ্ছি going-করতে to-উদযাপন celebrate-উদযাপন his-তার birthday-জন্মদিন] (আমরা তার জন্মদিন উদযাপন করতে যাচ্ছি।)
- Celebration (সেলিব্রেশন) - উদযাপন [Noun] The celebration was a great success. [The-উদযাপন celebration-উদযাপন was-ছিল a-একটি great-বড় success-সফলতা] (উদযাপন একটি বড় সফলতা ছিল।)
- Cell (সেল) - কোষ [Noun] The human body is made up of cells. [The-মানব a human-মানব body-দেহ is-তৈরি made-তৈরি up-দিয়ে of-এর cells-কোষ] (মানবদেহ কোষ দিয়ে তৈরি।)
- Cemetery (সিমেট্রি) - কবরস্থান [Noun] He was buried in the local cemetery. [He-তাকে was-কবর দেওয়া হয়েছিল buried-কবর দেওয়া হয়েছিল in-the-স্থানীয় local-স্থানীয় cemetery-কবরস্থানে] (তাকে স্থানীয় কবরস্থানে কবর দেওয়া হয়েছিল।)
- Cent (সেন্ট) - সেন্ট [Noun] I don't have a single cent. [I-আমার don't-নেই have-নেই a-একটি single-একক cent-সেন্ট] (আমার একটিও সেন্ট নেই।)
- Center (সেন্টার) - কেন্দ্র [Noun] The shopping center is very crowded. [The-শপিং shopping-শপিং center-সেন্টার is-হয় very-খুব crowded-ভিড়] (শপিং সেন্টার খুব ভিড়।)
- Central (সেন্ট্রাল) - কেন্দ্রীয় [Adjective] He is a central figure in the government. [He-তিনি is-হন a-একজন central-কেন্দ্রীয় figure-ব্যক্তি in-the-সরকারে government-সরকার] (তিনি সরকারের একজন কেন্দ্রীয় ব্যক্তি।)
- Century (সেঞ্চুরি) - শতাব্দী [Noun] We are living in the 21st century. [We-আমরা are-বসবাস করছি living-বসবাস করছি in-the-একবিংশ 21st-একবিংশ century-শতাব্দীতে] (আমরা একবিংশ শতাব্দীতে বসবাস করছি।)
- Ceremony (সেরিমনি) - অনুষ্ঠান [Noun] The wedding ceremony was beautiful. [The-বিবাহ wedding-বিবাহ ceremony-অনুষ্ঠান was-ছিল beautiful-সুন্দর] (বিবাহ অনুষ্ঠান সুন্দর ছিল।)
- Certain (সার্টেন) - নিশ্চিত [Adjective] I am certain that he will come. [I-আমি am-নিশ্চিত certain-নিশ্চিত that-যে he-সে will-আসবে come-আসবে] (আমি নিশ্চিত যে সে আসবে।)
- Certainly (সার্টেনলি) - অবশ্যই [Adverb] I will certainly help you. [I-আমি will-অবশ্যই certainly-অবশ্যই help-সাহায্য করব you-তোমাকে] (আমি অবশ্যই তোমাকে সাহায্য করব।)
- Chain (চেইন) - শিকল [Noun] The dog is tied with a chain. [The-কুকুরটি dog-কুকুর is-বাঁধা আছে tied-বাঁধা with-দিয়ে a-একটি chain-শিকল] (কুকুরটি একটি শিকল দিয়ে বাঁধা আছে।)
- Chair (চেয়ার) - চেয়ার [Noun] Please have a chair. [Please-দয়া করে have-বসুন a-একটি chair-চেয়ারে] (দয়া করে একটি চেয়ারে বসুন।)
- Chairman (চেয়ারম্যান) - চেয়ারম্যান [Noun] He is the chairman of the company. [He-তিনি is-হন the-চেয়ারম্যান chairman-চেয়ারম্যান of-এর the-কোম্পানির company-কোম্পানি] (তিনি কোম্পানির চেয়ারম্যান।)
- Challenge (চ্যালেঞ্জ) - চ্যালেঞ্জ [Noun] I accept your challenge. [I-আমি accept-গ্রহণ করি your-তোমার challenge-চ্যালেঞ্জ] (আমি তোমার চ্যালেঞ্জ গ্রহণ করি।)
- Chamber (চেম্বার) - কক্ষ [Noun] The king was in his chamber. [The-রাজা king-রাজা was-ছিলেন in-his-তার chamber-কক্ষে] (রাজা তার কক্ষে ছিলেন।)
- Champion (চ্যাম্পিয়ন) - চ্যাম্পিয়ন [Noun] He is the world champion. [He-সে is-হয় the-বিশ্ব world-বিশ্ব champion-চ্যাম্পিয়ন] (সে বিশ্ব চ্যাম্পিয়ন।)
- Chance (চান্স) - সুযোগ [Noun] Give me a chance. [Give-দাও me-আমাকে a-একটি chance-সুযোগ] (আমাকে একটি সুযোগ দাও।)
- Change (চেঞ্জ) - পরিবর্তন [Verb] I want to change my dress. [I-আমি want-চাই to-পরিবর্তন করতে change-পরিবর্তন করতে my-আমার dress-পোশাক] (আমি আমার পোশাক পরিবর্তন করতে চাই।)
- Channel (চ্যানেল) - চ্যানেল [Noun] What is your favorite TV channel? [What-কি is-হয় your-তোমার favorite-প্রিয় TV-টিভি channel-চ্যানেল] (তোমার প্রিয় টিভি চ্যানেল কি?)
- Chapter (চ্যাপ্টার) - অধ্যায় [Noun] I have read the first chapter of the book. [I-আমি have-পড়েছি read-পড়েছি the-প্রথম first-প্রথম chapter-অধ্যায় of-এর the-বইটির book-বই] (আমি বইটির প্রথম অধ্যায় পড়েছি।)
- Character (ক্যারেক্টার) - চরিত্র [Noun] He has a strong character. [He-তার has-আছে a-একটি strong-দৃঢ় character-চরিত্র] (তার একটি দৃঢ় চরিত্র আছে।)
- Characteristic (ক্যারেক্টারিস্টিক) - বৈশিষ্ট্য [Noun] What are the characteristics of a good leader? [What-কি are-হয় the-বৈশিষ্ট্যগুলো characteristics-বৈশিষ্ট্য of-এর a-একজন good-ভালো leader-নেতার] (একজন ভালো নেতার বৈশিষ্ট্যগুলো কি?)
- Charge (চার্জ) - অভিযোগ [Noun] He was arrested on a charge of theft. [He-তাকে was-গ্রেপ্তার করা হয়েছিল arrested-গ্রেপ্তার করা হয়েছিল on-a-একটি charge-অভিযোগে of-এর theft-চুরির] (তাকে চুরির অভিযোগে গ্রেপ্তার করা হয়েছিল।)
- Charity (চ্যারিটি) - দাতব্য [Noun] He donated a lot of money to charity. [He-তিনি donated-দান করেছেন a-অনেক lot-অনেক of-এর money-টাকা to-দাতব্যে charity-দাতব্য] (তিনি দাতব্যে অনেক টাকা দান করেছেন।)
- Charm (চার্ম) - আকর্ষণ [Noun] She has a lot of charm. [She-তার has-আছে a-অনেক lot-অনেক of-এর charm-আকর্ষণ] (তার অনেক আকর্ষণ আছে।)
- Chart (চার্ট) - চার্ট [Noun] The doctor is looking at the patient's chart. [The-ডাক্তার doctor-ডাক্তার is-দেখছেন looking-দেখছেন at-the-রোগীর patient's-রোগী chart-চার্ট] (ডাক্তার রোগীর চার্ট দেখছেন।)
- Chase (চেজ) - তাড়া করা [Verb] The cat is chasing the mouse. [The-বিড়ালটি cat-বিড়াল is-তাড়া করছে chasing-তাড়া করছে the-ইঁদুরটিকে mouse-ইঁদুর] (বিড়ালটি ইঁদুরটিকে তাড়া করছে।)
- Chat (চ্যাট) - আড্ডা [Noun] We had a long chat. [We-আমরা had-করেছিলাম a-একটি long-দীর্ঘ chat-আড্ডা] (আমরা একটি দীর্ঘ আড্ডা করেছিলাম।)
- Cheap (চীফ) - সস্তা [Adjective] The dress is very cheap. [The-পোশাকটি dress-পোশাক is-হয় very-খুব cheap-সস্তা] (পোশাকটি খুব সস্তা।)
- Cheat (চীট) - প্রতারণা করা [Verb] He cheated in the exam. [He-সে cheated-প্রতারণা করেছে in-the-পরীক্ষায় exam-পরীক্ষা] (সে পরীক্ষায় প্রতারণা করেছে।)
- Check (চেক) - পরীক্ষা করা [Verb] Please check your answers. [Please-দয়া করে check-পরীক্ষা করুন your-তোমার answers-উত্তরগুলো] (দয়া করে তোমার উত্তরগুলো পরীক্ষা করুন।)
- Cheek (চীক) - গাল [Noun] The baby has chubby cheeks. [The-শিশুটির baby-শিশু has-আছে chubby-মোটা cheeks-গাল] (শিশুটির মোটা গাল আছে।)
- Cheer (চিয়ার) - উল্লাস করা [Verb] The crowd cheered for their team. [The-জনতা crowd-জনতা cheered-উল্লাস করেছে for-জন্য their-তাদের team-দলের] (জনতা তাদের দলের জন্য উল্লাস করেছে।)
- Cheese (চীজ) - পনির [Noun] I like to eat cheese. [I-আমি like-পছন্দ করি to-খেতে eat-খেতে cheese-পনির] (আমি পনির খেতে পছন্দ করি।)
- Chef (শেফ) - শেফ [Noun] He is a famous chef. [He-তিনি is-হন a-একজন famous-বিখ্যাত chef-শেফ] (তিনি একজন বিখ্যাত শেফ।)
- Chemical (কেমিক্যাল) - রাসায়নিক [Noun] This is a dangerous chemical. [This-এটা is-হয় a-একটি dangerous-বিপজ্জনক chemical-রাসায়নিক] (এটা একটি বিপজ্জনক রাসায়নিক।)
- Chemistry (কেমিস্ট্রি) - রসায়ন [Noun] I am studying chemistry. [I-আমি am-পড়ছি studying-পড়ছি chemistry-রসায়ন] (আমি রসায়ন পড়ছি।)
- Chest (চেস্ট) - বুক [Noun] He has a broad chest. [He-তার has-আছে a-একটি broad-প্রশস্ত chest-বুক] (তার একটি প্রশস্ত বুক আছে।)
- Chew (চিউ) - চিবানো [Verb] Chew your food properly. [Chew-চিবান your-তোমার food-খাবার properly-সঠিকভাবে] (তোমার খাবার সঠিকভাবে চিবান।)
- Chicken (চিকেন) - মুরগি [Noun] I like to eat chicken. [I-আমি like-পছন্দ করি to-খেতে eat-খেতে chicken-মুরগি] (আমি মুরগি খেতে পছন্দ করি।)
- Chief (চীফ) - প্রধান [Noun] He is the chief of the tribe. [He-তিনি is-হন the-প্রধান chief-প্রধান of-এর the-উপজাতির tribe-উপজাতি] (তিনি উপজাতির প্রধান।)
- Child (চাইল্ড) - শিশু [Noun] The child is playing with a toy. [The-শিশুটা child-শিশু is-খেলছে playing-খেলছে with-দিয়ে a-একটি toy-খেলনা] (শিশুটা একটি খেলনা দিয়ে খেলছে।)
- Childhood (চাইল্ডহুড) - শৈশব [Noun] I had a happy childhood. [I-আমার had-ছিল a-একটি happy-সুখী childhood-শৈশব] (আমার একটি সুখী শৈশব ছিল।)
- Chin (চিন) - চিবুক [Noun] He has a double chin. [He-তার has-আছে a-একটি double-দ্বৈত chin-চিবুক] (তার একটি দ্বৈত চিবুক আছে।)
- Chip (চিপ) - চিপ [Noun] I like to eat potato chips. [I-আমি like-পছন্দ করি to-খেতে eat-খেতে potato-আলুর chips-চিপস] (আমি আলুর চিপস খেতে পছন্দ করি।)
- Chocolate (চকলেট) - চকলেট [Noun] I love chocolate. [I-আমি love-ভালোবাসি chocolate-চকলেট] (আমি চকলেট ভালোবাসি।)
- Choice (চয়েস) - পছন্দ [Noun] You have no choice. [You-তোমার have-নেই no-নেই choice-পছন্দ] (তোমার কোন পছন্দ নেই।)
- Choose (চুজ) - পছন্দ করা [Verb] You have to choose one. [You-তোমাকে have-করতে হবে to-পছন্দ করতে choose-পছন্দ করতে one-একটি] (তোমাকে একটি পছন্দ করতে হবে।)
- Chop (চপ) - কাটা [Verb] Please chop the vegetables. [Please-দয়া করে chop-কাটুন the-সবজিগুলো vegetables-সবজি] (দয়া করে সবজিগুলো কাটুন।)
- Church (চার্চ) - গির্জা [Noun] We go to church on Sundays. [We-আমরা go-যাই to-গির্জায় church-গির্জা on-রবিবারে Sundays-রবিবার] (আমরা রবিবারে গির্জায় যাই।)
- Cigarette (সিগারেট) - সিগারেট [Noun] Smoking cigarettes is bad for your health. [Smoking-ধূমপান করা cigarettes-সিগারেট is-হয় bad-খারাপ for-জন্য your-তোমার health-স্বাস্থ্যের] (সিগারেট ধূমপান করা তোমার স্বাস্থ্যের জন্য খারাপ।)
- Circle (সার্কেল) - বৃত্ত [Noun] Draw a circle. [Draw-আঁকুন a-একটি circle-বৃত্ত] (একটি বৃত্ত আঁকুন।)
- Circumstance (সারকামস্ট্যান্স) - পরিস্থিতি [Noun] Under the circumstances, we have to cancel the trip. [Under-অধীনে the-পরিস্থিতির circumstances-পরিস্থিতি, we-আমাদের have-করতে হবে to-বাতিল করতে cancel-বাতিল করতে the-ভ্রমণটি trip-ভ্রমণ] (পরিস্থিতির অধীনে, আমাদের ভ্রমণটি বাতিল করতে হবে।)
- Cite (সাইট) - উদ্ধৃত করা [Verb] Can you cite an example? [Can-তুমি কি you-তুমি cite-উদ্ধৃত করতে পারো an-একটি example-উদাহরণ] (তুমি কি একটি উদাহরণ উদ্ধৃত করতে পারো?)
- Citizen (সিটিজেন) - নাগরিক [Noun] I am a citizen of this country. [I-আমি am-হই a-একজন citizen-নাগরিক of-এর this-এই country-দেশের] (আমি এই দেশের একজন নাগরিক।)
- City (সিটি) - শহর [Noun] I live in a big city. [I-আমি live-থাকি in-a-একটি big-বড় city-শহরে] (আমি একটি বড় শহরে থাকি।)
- Civil (সিভিল) - বেসামরিক [Adjective] He is a civil engineer. [He-তিনি is-হন a-একজন civil-বেসামরিক engineer-প্রকৌশলী] (তিনি একজন বেসামরিক প্রকৌশলী।)
- Claim (ক্লেইম) - দাবি করা [Verb] He claimed that he was innocent. [He-সে claimed-দাবি করেছে that-যে he-সে was-ছিল innocent-নিরপরাধ] (সে দাবি করেছে যে সে নিরপরাধ ছিল।)
- Class (ক্লাস) - শ্রেণী [Noun] I am in class 10. [I-আমি am-আছি in-class-দশম 10-দশ] (আমি দশম শ্রেণীতে আছি।)
- Classic (ক্লাসিক) - ক্লাসিক [Adjective] This is a classic movie. [This-এটা is-হয় a-একটি classic-ক্লাসিক movie-চলচ্চিত্র] (এটা একটি ক্লাসিক চলচ্চিত্র।)
- Classroom (ক্লাসরুম) - শ্রেণীকক্ষ [Noun] The students are in the classroom. [The-ছাত্রছাত্রীরা students-ছাত্রছাত্রী are-আছে in-the-শ্রেণীকক্ষে classroom-শ্রেণীকক্ষ] (ছাত্রছাত্রীরা শ্রেণীকক্ষে আছে।)
- Clause (ক্লজ) - ধারা [Noun] There is a new clause in the contract. [There-সেখানে is-আছে a-একটি new-নতুন clause-ধারা in-the-চুক্তিতে contract-চুক্তি] (চুক্তিতে একটি নতুন ধারা আছে।)
- Clay (ক্লে) - কাদা [Noun] The pot is made of clay. [The-পাত্রটি pot-পাত্র is-তৈরি made-তৈরি of-দিয়ে clay-কাদা] (পাত্রটি কাদা দিয়ে তৈরি।)
- Clean (ক্লিন) - পরিষ্কার [Adjective] The room is very clean. [The-ঘরটি room-ঘর is-হয় very-খুব clean-পরিষ্কার] (ঘরটি খুব পরিষ্কার।)
- Clear (ক্লিয়ার) - পরিষ্কার [Adjective] The water is very clear. [The-জল water-জল is-হয় very-খুব clear-পরিষ্কার] (জল খুব পরিষ্কার।)
- Clearly (ক্লিয়ারলি) - পরিষ্কারভাবে [Adverb] I can see clearly now. [I-আমি can-দেখতে পাচ্ছি see-দেখতে clearly-পরিষ্কারভাবে now-এখন] (আমি এখন পরিষ্কারভাবে দেখতে পাচ্ছি।)
- Client (ক্লায়েন্ট) - মক্কেল [Noun] The lawyer is talking to his client. [The-আইনজীবী lawyer-আইনজীবী is-কথা বলছে talking-কথা বলছে to-his-তার client-মক্কেলের সাথে] (আইনজীবী তার মক্কেলের সাথে কথা বলছে।)
- Climate (ক্লাইমেট) - জলবায়ু [Noun] The climate of this region is very pleasant. [The-জলবায়ু climate-জলবায়ু of-এর this-এই region-অঞ্চলের is-হয় very-খুব pleasant- মনোরম] (এই অঞ্চলের জলবায়ু খুব মনোরম।)
- Climb (ক্লাইম্ব) - আরোহণ করা [Verb] I want to climb that mountain. [I-আমি want-চাই to-আরোহণ করতে climb-আরোহণ করতে that-ঐ mountain-পাহাড়ে] (আমি ঐ পাহাড়ে আরোহণ করতে চাই।)
- Clinic (ক্লিনিক) - ক্লিনিক [Noun] I am going to the clinic. [I-আমি am-যাচ্ছি going-যাচ্ছি to-the-ক্লিনিকে clinic-ক্লিনিক] (আমি ক্লিনিকে যাচ্ছি।)
- Clock (ক্লক) - ঘড়ি [Noun] The clock is on the wall. [The-ঘড়িটি clock-ঘড়ি is-আছে on-the-দেয়ালে wall-দেয়াল] (ঘড়িটি দেয়ালে আছে।)
- Close (ক্লোজ) - বন্ধ করা [Verb] Please close the door. [Please-দয়া করে close-বন্ধ করুন the-দরজাটি door-দরজা] (দয়া করে দরজাটি বন্ধ করুন।)
- Closely (ক্লোজলি) - ঘনিষ্ঠভাবে [Adverb] I am watching him closely. [I-আমি am-দেখছি watching-দেখছি him-তাকে closely- ঘনিষ্ঠভাবে] (আমি তাকে ঘনিষ্ঠভাবে দেখছি।)
- Closet (ক্লোজেট) - আলমারি [Noun] My clothes are in the closet. [My-আমার clothes-পোশাক are-আছে in-the-আলমারিতে closet-আলমারি] (আমার পোশাক আলমারিতে আছে।)
- Cloth (ক্লথ) - কাপড় [Noun] I need a piece of cloth. [I-আমার need-দরকার a-একটি piece-টুকরা of-এর cloth-কাপড়ের] (আমার এক টুকরা কাপড়ের দরকার।)
- Clothes (ক্লোদস) - পোশাক [Noun] I need to buy some new clothes. [I-আমার need-দরকার to-কিনতে buy-কিনতে some-কিছু new-নতুন clothes-পোশাক] (আমার কিছু নতুন পোশাক কিনতে হবে।)
- Cloud (ক্লাউড) - মেঘ [Noun] The sky is full of clouds. [The-আকাশ sky-আকাশ is-ভরা full-ভরা of-দিয়ে clouds-মেঘ] (আকাশ মেঘে ভরা।)
- Club (ক্লাব) - ক্লাব [Noun] I am a member of this club. [I-আমি am-সদস্য a-একজন member-সদস্য of-এর this-এই club-ক্লাবের] (আমি এই ক্লাবের একজন সদস্য।)
- Clue (ক্লু) - সূত্র [Noun] The police are looking for clues. [The-পুলিশ police-পুলিশ are-খুঁজছে looking-খুঁজছে for-জন্য clues-সূত্র] (পুলিশ সূত্রের জন্য খুঁজছে।)
- Coach (কোচ) - কোচ [Noun] He is the coach of our team. [He-তিনি is-হন the-কোচ coach-কোচ of-এর our-আমাদের team-দলের] (তিনি আমাদের দলের কোচ।)
- Coal (কোল) - কয়লা [Noun] Coal is used to generate electricity. [Coal-কয়লা is-ব্যবহৃত হয় used-ব্যবহৃত হয় to-উৎপাদন করতে generate-উৎপাদন করতে electricity-বিদ্যুৎ] (কয়লা বিদ্যুৎ উৎপাদন করতে ব্যবহৃত হয়।)
- Coalition (কোয়ালিশন) - জোট [Noun] The two parties have formed a coalition. [The-দুটি the two-দুটি parties-দল have-গঠন করেছে formed-গঠন করেছে a-একটি coalition-জোট] (দুটি দল একটি জোট গঠন করেছে।)
- Coast (কোস্ট) - উপকূল [Noun] We are driving along the coast. [We-আমরা are-চালাচ্ছি driving-চালাচ্ছি along-বরাবর the-উপকূল coast-উপকূল] (আমরা উপকূল বরাবর চালাচ্ছি।)
- Coat (কোট) - কোট [Noun] I am wearing a coat. [I-আমি am-পরে আছি wearing-পরে আছি a-একটি coat-কোট] (আমি একটি কোট পরে আছি।)
- Code (কোড) - কোড [Noun] I am learning to code. [I-আমি am-শিখছি learning-শিখছি to-কোড করতে code-কোড] (আমি কোড করতে শিখছি।)
- Coffee (কফি) - কফি [Noun] I like to drink coffee in the morning. [I-আমি like-পছন্দ করি to-পান করতে drink-পান করতে coffee-কফি in-the-সকালে morning-সকাল] (আমি সকালে কফি পান করতে পছন্দ করি।)
- Coin (কয়েন) - মুদ্রা [Noun] I have a coin in my pocket. [I-আমার have-আছে a-একটি coin-মুদ্রা in-my-আমার pocket-পকেটে] (আমার পকেটে একটি মুদ্রা আছে।)
- Cold (কোল্ড) - ঠান্ডা [Adjective] The weather is very cold today. [The-আবহাওয়া weather-আবহাওয়া is-হয় very-খুব cold-ঠান্ডা today-আজ] (আজ আবহাওয়া খুব ঠান্ডা।)
- Collapse (কোল্যাপ্স) - ধসে পড়া [Verb] The building collapsed. [The-ভবনটি building-ভবন collapsed-ধসে পড়েছে] (ভবনটি ধসে পড়েছে।)
- Colleague (কলিগ) - সহকর্মী [Noun] He is my colleague. [He-সে is-হয় my-আমার colleague-সহকর্মী] (সে আমার সহকর্মী।)
- Collect (কালেক্ট) - সংগ্রহ করা [Verb] I like to collect stamps. [I-আমি like-পছন্দ করি to-সংগ্রহ করতে collect-সংগ্রহ করতে stamps-ডাকটিকিট] (আমি ডাকটিকিট সংগ্রহ করতে পছন্দ করি।)
- Collection (কালেকশন) - সংগ্রহ [Noun] I have a large collection of stamps. [I-আমার have-আছে a-একটি large-বড় collection-সংগ্রহ of-এর stamps-ডাকটিকিটের] (আমার একটি বড় ডাকটিকিটের সংগ্রহ আছে।)
- Collective (কালেক্টিভ) - সম্মিলিত [Adjective] It was a collective decision. [It-এটা was-ছিল a-একটি collective-সম্মিলিত decision-সিদ্ধান্ত] (এটা একটি সম্মিলিত সিদ্ধান্ত ছিল।)
- College (কলেজ) - কলেজ [Noun] I am a college student. [I-আমি am-একজন a-একজন college-কলেজ student-ছাত্র] (আমি একজন কলেজ ছাত্র।)
- Color (কালার) - রঙ [Noun] What is your favorite color? [What-কি is-হয় your-তোমার favorite-প্রিয় color-রঙ] (তোমার প্রিয় রঙ কি?)
- Column (কলাম) - কলাম [Noun] The newspaper has a column on politics. [The-সংবাদপত্রটিতে newspaper-সংবাদপত্র has-আছে a-একটি column-কলাম on-রাজনীতির উপর politics-রাজনীতি] (সংবাদপত্রটিতে রাজনীতির উপর একটি কলাম আছে।)
- Combination (কম্বিনেশন) - সমন্বয় [Noun] The combination of colors is beautiful. [The-সমন্বয় combination-সমন্বয় of-এর colors-রঙের is-হয় beautiful-সুন্দর] (রঙের সমন্বয় সুন্দর।)
- Combine (কম্বাইন) - একত্রিত করা [Verb] We need to combine our efforts. [We-আমাদের need-দরকার to-একত্রিত করতে combine-একত্রিত করতে our-আমাদের efforts-প্রচেষ্টা] (আমাদের প্রচেষ্টা একত্রিত করতে হবে।)
- Come (কাম) - আসা [Verb] Please come here. [Please-দয়া করে come-আসুন here-এখানে] (দয়া করে এখানে আসুন।)
- Comedy (কমেডি) - কমেডি [Noun] I like to watch comedy movies. [I-আমি like-পছন্দ করি to-দেখতে watch-দেখতে comedy-কমেডি movies-চলচ্চিত্র] (আমি কমেডি চলচ্চিত্র দেখতে পছন্দ করি।)
- Comfort (কমফোর্ট) - আরাম [Noun] I need some comfort. [I-আমার need-দরকার some-কিছু comfort-আরাম] (আমার কিছু আরাম দরকার।)
- Comfortable (কমফোর্টেবল) - আরামদায়ক [Adjective] The chair is very comfortable. [The-চেয়ারটি chair-চেয়ার is-হয় very-খুব comfortable-আরামদায়ক] (চেয়ারটি খুব আরামদায়ক।)
- Command (কমান্ড) - আদেশ [Noun] The soldiers followed the command. [The-সৈনিকরা soldiers-সৈনিক followed-অনুসরণ করেছে the-আদেশ command-আদেশ] (সৈনিকরা আদেশ অনুসরণ করেছে।)
- Commander (কমান্ডার) - কমান্ডার [Noun] He is the commander of the army. [He-তিনি is-হন the-কমান্ডার commander-কমান্ডার of-এর the-সেনাবাহিনীর army-সেনাবাহিনী] (তিনি সেনাবাহিনীর কমান্ডার।)
- Comment (কমেন্ট) - মন্তব্য [Noun] I have no comment. [I-আমার have-নেই no-নেই comment-মন্তব্য] (আমার কোন মন্তব্য নেই।)
- Commercial (কমার্শিয়াল) - বাণিজ্যিক [Adjective] This is a commercial building. [This-এটা is-হয় a-একটি commercial-বাণিজ্যিক building-ভবন] (এটা একটি বাণিজ্যিক ভবন।)
- Commission (কমিশন) - কমিশন [Noun] I will get a commission for this sale. [I-আমি will-পাব get-পাব a-একটি commission-কমিশন for-জন্য this-এই sale-বিক্রয়ের] (আমি এই বিক্রয়ের জন্য একটি কমিশন পাব।)
- Commit (কমিট) - প্রতিশ্রুতিবদ্ধ হওয়া [Verb] I am committed to my work. [I-আমি am-প্রতিশ্রুতিবদ্ধ committed-প্রতিশ্রুতিবদ্ধ to-my-আমার work-কাজের প্রতি] (আমি আমার কাজের প্রতি প্রতিশ্রুতিবদ্ধ।)
- Commitment (কমিটমেন্ট) - প্রতিশ্রুতি [Noun] I have a commitment to my family. [I-আমার have-আছে a-একটি commitment-প্রতিশ্রুতি to-my-আমার family-পরিবারের প্রতি] (আমার পরিবারের প্রতি একটি প্রতিশ্রুতি আছে।)
- Committee (কমিটি) - কমিটি [Noun] The committee will meet tomorrow. [The-কমিটি committee-কমিটি will-মিলিত হবে meet-মিলিত হবে tomorrow-আগামীকাল] (কমিটি আগামীকাল মিলিত হবে।)
- Common (কমন) - সাধারণ [Adjective] This is a common problem. [This-এটা is-হয় a-একটি common-সাধারণ problem-সমস্যা] (এটা একটি সাধারণ সমস্যা।)
- Communicate (কমিউনিকেট) - যোগাযোগ করা [Verb] We need to communicate with each other. [We-আমাদের need-দরকার to-যোগাযোগ করতে communicate-যোগাযোগ করতে with-each-একে other-অন্যের সাথে] (আমাদের একে অন্যের সাথে যোগাযোগ করতে হবে।)
- Communication (কমিউনিকেশন) - যোগাযোগ [Noun] Communication is very important. [Communication-যোগাযোগ is-হয় very-খুব important-গুরুত্বপূর্ণ] (যোগাযোগ খুব গুরুত্বপূর্ণ।)
- Community (কমিউনিটি) - সম্প্রদায় [Noun] I live in a friendly community. [I-আমি live-থাকি in-a-একটি friendly-বন্ধুত্বপূর্ণ community-সম্প্রদায়ে] (আমি একটি বন্ধুত্বপূর্ণ সম্প্রদায়ে থাকি।)
- Company (কোম্পানি) - কোম্পানি [Noun] I work for a big company. [I-আমি work-কাজ করি for-a-একটি big-বড় company-কোম্পানিতে] (আমি একটি বড় কোম্পানিতে কাজ করি।)
- Compare (কম্পেয়ার) - তুলনা করা [Verb] Don't compare me to others. [Don't-করো না compare-তুলনা me-আমাকে to-others-অন্যদের সাথে] (আমাকে অন্যদের সাথে তুলনা করো না।)
- Comparison (কম্পারিজন) - তুলনা [Noun] There is no comparison between them. [There-সেখানে is-নেই no-নেই comparison-তুলনা between-them-তাদের মধ্যে] (তাদের মধ্যে কোন তুলনা নেই।)
- Compete (কমপিট) - প্রতিযোগিতা করা [Verb] I will compete in the race. [I-আমি will-প্রতিযোগিতা করব compete-প্রতিযোগিতা করব in-the-দৌড়ে race-দৌড়] (আমি দৌড়ে প্রতিযোগিতা করব।)
- Competition (কম্পিটিশন) - প্রতিযোগিতা [Noun] The competition was very tough. [The-প্রতিযোগিতা competition-প্রতিযোগিতা was-ছিল very-খুব tough-কঠিন] (প্রতিযোগিতা খুব কঠিন ছিল।)
- Competitive (কম্পিটিটিভ) - প্রতিযোগিতামূলক [Adjective] He is a very competitive person. [He-সে is-হয় a-একজন very-খুব competitive-প্রতিযোগিতামূলক person-ব্যক্তি] (সে একজন খুব প্রতিযোগিতামূলক ব্যক্তি।)
- Complain (কমপ্লেইন) - অভিযোগ করা [Verb] He is always complaining. [He-সে is-সর্বদা always-সর্বদা complaining-অভিযোগ করছে] (সে সর্বদা অভিযোগ করছে।)
- Complaint (কমপ্লেইন্ট) - অভিযোগ [Noun] I have a complaint to make. [I-আমার have-আছে a-একটি complaint-অভিযোগ to-করার make-করার] (আমার একটি অভিযোগ করার আছে।)
- Complete (কমপ্লিট) - সম্পূর্ণ [Adjective] The work is complete. [The-কাজটি work-কাজ is-হয় complete-সম্পূর্ণ] (কাজটি সম্পূর্ণ।)
- Completely (কমপ্লিটলি) - সম্পূর্ণরূপে [Adverb] I am completely exhausted. [I-আমি am-সম্পূর্ণরূপে completely-সম্পূর্ণরূপে exhausted-ক্লান্ত] (আমি সম্পূর্ণরূপে ক্লান্ত।)
- Complex (কমপ্লেক্স) - জটিল [Adjective] The problem is very complex. [The-সমস্যাটি problem-সমস্যা is-হয় very-খুব complex-জটিল] (সমস্যাটি খুব জটিল।)
- Complicate (কমপ্লিকেট) - জটিল করা [Verb] Don't complicate the matter. [Don't-করো না complicate-জটিল the-বিষয়টি matter-বিষয়] (বিষয়টি জটিল করো না।)
- Component (কম্পোনেন্ট) - উপাদান [Noun] This is an important component of the machine. [This-এটা is-হয় an-একটি important-গুরুত্বপূর্ণ component-উপাদান of-এর the-যন্ত্রটির machine-যন্ত্র] (এটা যন্ত্রটির একটি গুরুত্বপূর্ণ উপাদান।)
- Compose (কম্পোজ) - রচনা করা [Verb] He composed a beautiful song. [He-সে composed-রচনা করেছে a-একটি beautiful-সুন্দর song-গান] (সে একটি সুন্দর গান রচনা করেছে।)
- Composition (কম্পোজিশন) - রচনা [Noun] The composition of the music is beautiful. [The-রচনা composition-রচনা of-এর the-সংগীতের music-সংগীত is-হয় beautiful-সুন্দর] (সংগীতের রচনা সুন্দর।)
- Comprehensive (কম্প্রিহেনসিভ) - ব্যাপক [Adjective] We need a comprehensive plan. [We-আমাদের need-দরকার a-একটি comprehensive-ব্যাপক plan-পরিকল্পনা] (আমাদের একটি ব্যাপক পরিকল্পনা দরকার।)
- Computer (কম্পিউটার) - কম্পিউটার [Noun] I have a new computer. [I-আমার have-আছে a-একটি new-নতুন computer-কম্পিউটার] (আমার একটি নতুন কম্পিউটার আছে।)
- Concentrate (কনসেনট্রেট) - মনোযোগ দেওয়া [Verb] Please concentrate on your work. [Please-দয়া করে concentrate-মনোযোগ দিন on-your-তোমার work-কাজে] (দয়া করে তোমার কাজে মনোযোগ দিন।)
- Concentration (কনসেনট্রেশন) - মনোযোগ [Noun] I need more concentration. [I-আমার need-দরকার more-আরও concentration-মনোযোগ] (আমার আরও মনোযোগ দরকার।)
- Concept (কনসেপ্ট) - ধারণা [Noun] I don't understand this concept. [I-আমি don't-বুঝতে পারছি না understand-বুঝতে this-এই concept-ধারণাটি] (আমি এই ধারণাটি বুঝতে পারছি না।)
- Concern (কনসার্ন) - উদ্বেগ [Noun] I have a concern about your health. [I-আমার have-আছে a-একটি concern-উদ্বেগ about-your-তোমার health-স্বাস্থ্য নিয়ে] (আমার তোমার স্বাস্থ্য নিয়ে একটি উদ্বেগ আছে।)
- Concerned (কনসার্নড) - উদ্বিগ্ন [Adjective] I am concerned about you. [I-আমি am-উদ্বিগ্ন concerned-উদ্বিগ্ন about-you-তোমার জন্য] (আমি তোমার জন্য উদ্বিগ্ন।)
- Concert (কনসার্ট) - কনসার্ট [Noun] I am going to a concert tonight. [I-আমি am-যাচ্ছি going-যাচ্ছি to-a-একটি concert-কনসার্টে tonight-আজ রাতে] (আমি আজ রাতে একটি কনসার্টে যাচ্ছি।)
- Conclude (কনক্লুড) - উপসংহার টানা [Verb] I would like to conclude my speech now. [I-আমি would-চাই like-চাই to-টানতে conclude-উপসংহার my-আমার speech-বক্তৃতার now-এখন] (আমি এখন আমার বক্তৃতার উপসংহার টানতে চাই।)
- Conclusion (কনক্লুশন) - উপসংহার [Noun] What is the conclusion of the story? [What-কি is-হয় the-উপসংহার conclusion-উপসংহার of-এর the-গল্পটির story-গল্প] (গল্পটির উপসংহার কি?)
- Concrete (কংক্রিট) - কংক্রিট [Noun] The building is made of concrete. [The-ভবনটি building-ভবন is-তৈরি made-তৈরি of-দিয়ে concrete-কংক্রিট] (ভবনটি কংক্রিট দিয়ে তৈরি।)
- Condition (কন্ডিশন) - শর্ত [Noun] I will help you on one condition. [I-আমি will-সাহায্য করব help-সাহায্য করব you-তোমাকে on-one-একটি condition-শর্তে] (আমি তোমাকে একটি শর্তে সাহায্য করব।)
- Conduct (কন্ডাক্ট) - পরিচালনা করা [Verb] The orchestra was conducted by a famous musician. [The-অর্কেস্ট্রা orchestra-অর্কেস্ট্রা was-পরিচালিত হয়েছিল conducted-পরিচালিত হয়েছিল by-দ্বারা a-একজন famous-বিখ্যাত musician-সংগীতজ্ঞের] (অর্কেস্ট্রা একজন বিখ্যাত সংগীতজ্ঞের দ্বারা পরিচালিত হয়েছিল।)
- Conference (কনফারেন্স) - সম্মেলন [Noun] I am attending a conference next week. [I-আমি am-অংশগ্রহণ করছি attending-অংশগ্রহণ করছি a-একটি conference-সম্মেলনে next-আগামী week-সপ্তাহে] (আমি আগামী সপ্তাহে একটি সম্মেলনে অংশগ্রহণ করছি।)
- Confidence (কনফিডেন্স) - আত্মবিশ্বাস [Noun] I have confidence in you. [I-আমার have-আছে confidence-আত্মবিশ্বাস in-you-তোমার উপর] (আমার তোমার উপর আত্মবিশ্বাস আছে।)
- Confident (কনফিডেন্ট) - আত্মবিশ্বাসী [Adjective] I am confident that I will win. [I-আমি am-আত্মবিশ্বাসী confident-আত্মবিশ্বাসী that-যে I-আমি will-জিতব win-জিতব] (আমি আত্মবিশ্বাসী যে আমি জিতব।)
- Confirm (কনফার্ম) - নিশ্চিত করা [Verb] Please confirm your booking. [Please-দয়া করে confirm-নিশ্চিত করুন your-তোমার booking-বুকিং] (দয়া করে তোমার বুকিং নিশ্চিত করুন।)
- Conflict (কনফ্লিক্ট) - সংঘাত [Noun] There is a conflict between the two countries. [There-সেখানে is-আছে a-একটি conflict-সংঘাত between-the-দুটি two-দুটি countries-দেশের মধ্যে] (দুটি দেশের মধ্যে একটি সংঘাত আছে।)
- Confront (কনফ্রন্ট) - মোকাবেলা করা [Verb] You have to confront your fears. [You-তোমাকে have-করতে হবে to-মোকাবেলা করতে confront-মোকাবেলা করতে your-তোমার fears-ভয়] (তোমাকে তোমার ভয় মোকাবেলা করতে হবে।)
- Confuse (কনফিউজ) - বিভ্রান্ত করা [Verb] Don't confuse me. [Don't-করো না confuse-বিভ্রান্ত me-আমাকে] (আমাকে বিভ্রান্ত করো না।)
- Congress (কংগ্রেস) - কংগ্রেস [Noun] The Congress is in session. [The-কংগ্রেস Congress-কংগ্রেস is-অধিবেশনে আছে in-session-অধিবেশন] (কংগ্রেস অধিবেশনে আছে।)
- Connect (কানেক্ট) - সংযোগ করা [Verb] Please connect the two wires. [Please-দয়া করে connect-সংযোগ করুন the-দুটি the two-দুটি wires-তার] (দয়া করে দুটি তার সংযোগ করুন।)
- Connection (কানেকশন) - সংযোগ [Noun] The connection is very weak. [The-সংযোগ connection-সংযোগ is-হয় very-খুব weak-দুর্বল] (সংযোগ খুব দুর্বল।)
- Consciousness (কনশাসনেস) - চেতনা [Noun] He lost consciousness after the accident. [He-সে lost-হারিয়েছে consciousness-চেতনা after-the-দুর্ঘটনার পর accident-দুর্ঘটনা] (দুর্ঘটনার পর সে চেতনা হারিয়েছে।)
- Consensus (কনসেনসাস) - ঐক্যমত্য [Noun] We have reached a consensus. [We-আমরা have-পৌঁছেছি reached-পৌঁছেছি a-একটি consensus-ঐক্যমত্যে] (আমরা একটি ঐক্যমত্যে পৌঁছেছি।)
- Consequence (কনসিকোয়েন্স) - পরিণতি [Noun] You have to face the consequences of your actions. [You-তোমাকে have-করতে হবে to-মোকাবেলা করতে face-মোকাবেলা করতে the-পরিণতি consequences-পরিণতি of-এর your-তোমার actions-কর্মের] (তোমাকে তোমার কর্মের পরিণতি মোকাবেলা করতে হবে।)
- Conservative (কনজারভেটিভ) - রক্ষণশীল [Adjective] He has very conservative views. [He-তার has-আছে very-খুব conservative-রক্ষণশীল views-মতামত] (তার খুব রক্ষণশীল মতামত আছে।)
- Consider (কনসিডার) - বিবেচনা করা [Verb] Please consider my request. [Please-দয়া করে consider-বিবেচনা করুন my-আমার request-অনুরোধ] (দয়া করে আমার অনুরোধ বিবেচনা করুন।)
- Considerable (কনসিডারেবল) - যথেষ্ট [Adjective] He has a considerable amount of money. [He-তার has-আছে a-একটি considerable-যথেষ্ট amount-পরিমাণ of-এর money-টাকা] (তার যথেষ্ট পরিমাণ টাকা আছে।)
- Consideration (কনসিডারেশন) - বিবেচনা [Noun] I will take your suggestion into consideration. [I-আমি will-নেব take-নেব your-তোমার suggestion-পরামর্শ into-বিবেচনায় consideration-বিবেচনা] (আমি তোমার পরামর্শ বিবেচনায় নেব।)
- Consist (কনসিস্ট) - গঠিত হওয়া [Verb] The team consists of 11 players. [The-দলটি team-দল consists-গঠিত of-দিয়ে 11-এগারো players-খেলোয়াড়] (দলটি এগারো জন খেলোয়াড় দিয়ে গঠিত।)
- Consistent (কনসিস্টেন্ট) - সামঞ্জস্যপূর্ণ [Adjective] His story is not consistent. [His-তার story-গল্প is-নয় not-নয় consistent-সামঞ্জস্যপূর্ণ] (তার গল্প সামঞ্জস্যপূর্ণ নয়।)
- Constant (কনস্ট্যান্ট) - ধ্রুবক [Adjective] The speed of light is constant. [The-আলোর the speed-গতি of-এর light-আলো is-হয় constant-ধ্রুবক] (আলোর গতি ধ্রুবক।)
- Constantly (কনস্ট্যান্টলি) - ক্রমাগত [Adverb] He is constantly talking. [He-সে is-ক্রমাগত constantly-ক্রমাগত talking-কথা বলছে] (সে ক্রমাগত কথা বলছে।)
- Constitute (কনস্টিটিউট) - গঠন করা [Verb] These twelve members constitute the committee. [These-এই twelve-বারো members-সদস্য constitute-গঠন করে the-কমিটি committee-কমিটি] (এই বারো জন সদস্য কমিটি গঠন করে।)
- Constitutional (কনস্টিটিউশনাল) - সাংবিধানিক [Adjective] This is a constitutional right. [This-এটা is-হয় a-একটি constitutional-সাংবিধানিক right-অধিকার] (এটা একটি সাংবিধানিক অধিকার।)
- Construct (কনস্ট্রাক্ট) - নির্মাণ করা [Verb] They are constructing a new bridge. [They-তারা are-নির্মাণ করছে constructing-নির্মাণ করছে a-একটি new-নতুন bridge-সেতু] (তারা একটি নতুন সেতু নির্মাণ করছে।)
- Construction (কনস্ট্রাকশন) - নির্মাণ [Noun] The construction of the building is complete. [The-নির্মাণ construction-নির্মাণ of-এর the-ভবনটির building-ভবন is-হয় complete-সম্পূর্ণ] (ভবনটির নির্মাণ সম্পূর্ণ।)
- Consultant (কনসালট্যান্ট) - পরামর্শক [Noun] He is a financial consultant. [He-তিনি is-হন a-একজন financial-আর্থিক consultant-পরামর্শক] (তিনি একজন আর্থিক পরামর্শক।)
- Consume (কনজিউম) - খাওয়া [Verb] We consume a lot of food every day. [We-আমরা consume-খাই a-অনেক lot-অনেক of-এর food-খাবার every-প্রতি day-দিন] (আমরা প্রতিদিন অনেক খাবার খাই।)
- Consumer (কনজিউমার) - ভোক্তা [Noun] The consumers have a right to know. [The-ভোক্তাদের consumers-ভোক্তা have-আছে a-একটি right-অধিকার to-জানার know-জানার] (ভোক্তাদের জানার অধিকার আছে।)
- Consumption (কনজাম্পশন) - খরচ [Noun] The consumption of electricity is very high. [The-খরচ consumption-খরচ of-এর electricity-বিদ্যুতের is-হয় very-খুব high-বেশি] (বিদ্যুতের খরচ খুব বেশি।)
- Contact (কন্টাক্ট) - যোগাযোগ [Noun] I have lost contact with him. [I-আমি have-হারিয়েছি lost-হারিয়েছি contact-যোগাযোগ with-him-তার সাথে] (আমি তার সাথে যোগাযোগ হারিয়েছি।)
- Contain (কন্টেইন) - ধারণ করা [Verb] This box contains a lot of things. [This-এই box-বাক্সটি contains-ধারণ করে a-অনেক lot-অনেক of-এর things-জিনিস] (এই বাক্সটি অনেক জিনিস ধারণ করে।)
- Container (কন্টেইনার) - ধারক [Noun] I need a container to store the food. [I-আমার need-দরকার a-একটি container-ধারক to-সংরক্ষণ করতে store-সংরক্ষণ করতে the-খাবার food-খাবার] (আমার খাবার সংরক্ষণ করতে একটি ধারক দরকার।)
- Contemporary (কন্টেম্পোরারি) - সমসাময়িক [Adjective] He is a contemporary artist. [He-তিনি is-হন a-একজন contemporary-সমসাময়িক artist-শিল্পী] (তিনি একজন সমসাময়িক শিল্পী।)
- Content (কন্টেন্ট) - বিষয়বস্তু [Noun] I am not happy with the content of this book. [I-আমি am-নই not-নই happy-খুশি with-the-বিষয়বস্তু নিয়ে content-বিষয়বস্তু of-এর this-এই book-বইটির] (আমি এই বইটির বিষয়বস্তু নিয়ে খুশি নই।)
- Contest (কনটেস্ট) - প্রতিযোগিতা [Noun] I am going to participate in a singing contest. [I-আমি am-অংশগ্রহণ করতে যাচ্ছি going-অংশগ্রহণ করতে to-অংশগ্রহণ করতে participate-অংশগ্রহণ করতে in-a-একটি singing-গান contest-প্রতিযোগিতায়] (আমি একটি গান প্রতিযোগিতায় অংশগ্রহণ করতে যাচ্ছি।)
- Context (কনটেক্সট) - প্রসঙ্গ [Noun] You have to understand the context of the story. [You-তোমাকে have-করতে হবে to-বুঝতে understand-বুঝতে the-প্রসঙ্গ context-প্রসঙ্গ of-এর the-গল্পটির story-গল্প] (তোমাকে গল্পটির প্রসঙ্গ বুঝতে হবে।)
- Continue (কন্টিনিউ) - চালিয়ে যাওয়া [Verb] Please continue your work. [Please-দয়া করে continue-চালিয়ে যান your-তোমার work-কাজ] (দয়া করে তোমার কাজ চালিয়ে যান।)
- Contract (কন্ট্রাক্ট) - চুক্তি [Noun] I have signed a contract with the company. [I-আমি have-স্বাক্ষর করেছি signed-স্বাক্ষর করেছি a-একটি contract-চুক্তি with-the-কোম্পানির সাথে company-কোম্পানি] (আমি কোম্পানির সাথে একটি চুক্তি স্বাক্ষর করেছি।)
- Contrast (কনট্রাস্ট) - বৈসাদৃশ্য [Noun] There is a big contrast between the two brothers. [There-সেখানে is-আছে a-একটি big-বড় contrast-বৈসাদৃশ্য between-the-দুটি two-দুটি brothers-ভাইয়ের মধ্যে] (দুটি ভাইয়ের মধ্যে একটি বড় বৈসাদৃশ্য আছে।)
- Contribute (কন্ট্রিবিউট) - অবদান রাখা [Verb] I want to contribute to the society. [I-আমি want-চাই to-অবদান রাখতে contribute-অবদান রাখতে to-the-সমাজে society-সমাজ] (আমি সমাজে অবদান রাখতে চাই।)
- Contribution (কন্ট্রিবিউশন) - অবদান [Noun] He made a great contribution to the science. [He-তিনি made-রেখেছেন a-একটি great-বড় contribution-অবদান to-the-বিজ্ঞানে science-বিজ্ঞান] (তিনি বিজ্ঞানে একটি বড় অবদান রেখেছেন।)
- Control (কন্ট্রোল) - নিয়ন্ত্রণ [Noun] I have no control over the situation. [I-আমার have-নেই no-নেই control-নিয়ন্ত্রণ over-the-পরিস্থিতির উপর situation-পরিস্থিতি] (আমার পরিস্থিতির উপর কোন নিয়ন্ত্রণ নেই।)
- Controversial (কন্ট্রোভার্সিয়াল) - বিতর্কিত [Adjective] This is a very controversial topic. [This-এটা is-হয় a-একটি very-খুব controversial-বিতর্কিত topic-বিষয়] (এটা একটি খুব বিতর্কিত বিষয়।)
- Controversy (কন্ট্রোভার্সি) - বিতর্ক [Noun] The new law has caused a lot of controversy. [The-নতুন the new-নতুন law-আইন has-সৃষ্টি করেছে caused-সৃষ্টি করেছে a-অনেক lot-অনেক of-এর controversy-বিতর্ক] (নতুন আইন অনেক বিতর্ক সৃষ্টি করেছে।)
- Convention (কনভেনশন) - সম্মেলন [Noun] I am attending a convention next week. [I-আমি am-অংশগ্রহণ করছি attending-অংশগ্রহণ করছি a-একটি convention-সম্মেলনে next-আগামী week-সপ্তাহে] (আমি আগামী সপ্তাহে একটি সম্মেলনে অংশগ্রহণ করছি।)
- Conventional (কনভেনশনাল) - প্রচলিত [Adjective] He has very conventional ideas. [He-তার has-আছে very-খুব conventional-প্রচলিত ideas-ধারণা] (তার খুব প্রচলিত ধারণা আছে।)
- Conversation (কনভারসেশন) - কথোপকথন [Noun] We had a long conversation. [We-আমরা had-করেছিলাম a-একটি long-দীর্ঘ conversation-কথোপকথন] (আমরা একটি দীর্ঘ কথোপকথন করেছিলাম।)
- Convert (কনভার্ট) - রূপান্তর করা [Verb] Can you convert this file to PDF? [Can-তুমি কি you-তুমি convert-রূপান্তর করতে পারো this-এই file-ফাইলটি to-PDF-এ] (তুমি কি এই ফাইলটি PDF-এ রূপান্তর করতে পারো?)
- Conviction (কনভিকশন) - দৃঢ় বিশ্বাস [Noun] I have a strong conviction that he is innocent. [I-আমার have-আছে a-একটি strong-দৃঢ় conviction-বিশ্বাস that-যে he-সে is-হয় innocent-নিরপরাধ] (আমার একটি দৃঢ় বিশ্বাস আছে যে সে নিরপরাধ।)
- Convince (কনভিন্স) - বোঝানো [Verb] I am trying to convince him. [I-আমি am-চেষ্টা করছি trying-চেষ্টা করছি to-বোঝাতে convince-বোঝাতে him-তাকে] (আমি তাকে বোঝাতে চেষ্টা করছি।)
- Cook (কুক) - রান্না করা [Verb] I like to cook. [I-আমি like-পছন্দ করি to-রান্না করতে cook-রান্না করতে] (আমি রান্না করতে পছন্দ করি।)
- Cookie (কুকি) - কুকি [Noun] I like to eat cookies. [I-আমি like-পছন্দ করি to-খেতে eat-খেতে cookies-কুকি] (আমি কুকি খেতে পছন্দ করি।)
- Cooking (কুকিং) - রান্না [Noun] I am learning cooking. [I-আমি am-শিখছি learning-শিখছি cooking-রান্না] (আমি রান্না শিখছি।)
- Cool (কুল) - ঠান্ডা [Adjective] The weather is cool today. [The-আবহাওয়া weather-আবহাওয়া is-হয় cool-ঠান্ডা today-আজ] (আজ আবহাওয়া ঠান্ডা।)
- Cooperation (কোঅপারেশন) - সহযোগিতা [Noun] We need your cooperation. [We-আমাদের need-দরকার your-তোমার cooperation-সহযোগিতা] (আমাদের তোমার সহযোগিতা দরকার।)
- Cop (কপ) - পুলিশ [Noun] The cop arrested the thief. [The-পুলিশ cop-পুলিশ arrested-গ্রেপ্তার করেছে the-চোরটিকে thief-চোর] (পুলিশ চোরটিকে গ্রেপ্তার করেছে।)
- Cope (কোপ) - মানিয়ে নেওয়া [Verb] I can't cope with this stress. [I-আমি can't-পারছি না cope-মানিয়ে নিতে with-this-এই stress-চাপের সাথে] (আমি এই চাপের সাথে মানিয়ে নিতে পারছি না।)
- Copy (কপি) - অনুলিপি [Noun] I need a copy of this document. [I-আমার need-দরকার a-একটি copy-অনুলিপি of-এর this-এই document-নথিটির] (আমার এই নথিটির একটি অনুলিপি দরকার।)
- Core (কোর) - মূল [Noun] This is the core of the problem. [This-এটা is-হয় the-মূল core-মূল of-এর the-সমস্যাটির problem-সমস্যা] (এটা সমস্যাটির মূল।)
- Corn (কর্ন) - ভুট্টা [Noun] I like to eat corn. [I-আমি like-পছন্দ করি to-খেতে eat-খেতে corn-ভুট্টা] (আমি ভুট্টা খেতে পছন্দ করি।)
- Corner (কর্নার) - কোণ [Noun] The shop is at the corner of the street. [The-দোকানটি shop-দোকান is-আছে at-the-কোণে corner-কোণ of-এর the-রাস্তাটির street-রাস্তা] (দোকানটি রাস্তাটির কোণে আছে।)
- Corporate (কর্পোরেট) - কর্পোরেট [Adjective] I work in a corporate office. [I-আমি work-কাজ করি in-a-একটি corporate-কর্পোরেট office-অফিসে] (আমি একটি কর্পোরেট অফিসে কাজ করি।)
- Corporation (কর্পোরেশন) - কর্পোরেশন [Noun] He works for a large corporation. [He-সে works-কাজ করে for-a-একটি large-বড় corporation-কর্পোরেশনে] (সে একটি বড় কর্পোরেশনে কাজ করে।)
- Correct (কারেক্ট) - সঠিক [Adjective] Your answer is correct. [Your-তোমার answer-উত্তর is-হয় correct-সঠিক] (তোমার উত্তর সঠিক।)
- Correspondent (করেসপন্ডেন্ট) - সংবাদদাতা [Noun] He is a foreign correspondent. [He-তিনি is-হন a-একজন foreign-বিদেশী correspondent-সংবাদদাতা] (তিনি একজন বিদেশী সংবাদদাতা।)
- Cost (কস্ট) - খরচ [Noun] What is the cost of this dress? [What-কি is-হয় the-খরচ cost-খরচ of-এর this-এই dress-পোশাকটির] (এই পোশাকটির খরচ কি?)
- Cotton (কটন) - তুলা [Noun] This shirt is made of cotton. [This-এই shirt-শার্টটি is-তৈরি made-তৈরি of-দিয়ে cotton-তুলা] (এই শার্টটি তুলা দিয়ে তৈরি।)
- Couch (কাউচ) - সোফা [Noun] I am sitting on the couch. [I-আমি am-বসে আছি sitting-বসে আছি on-the-সোফায় couch-সোফা] (আমি সোফায় বসে আছি।)
- Could (কুড) - পারতাম [Verb] I could not go to the party. [I-আমি could-পারিনি not-না go-যেতে to-the-পার্টিতে party-পার্টি] (আমি পার্টিতে যেতে পারিনি।)
- Council (কাউন্সিল) - পরিষদ [Noun] The city council will meet tomorrow. [The-শহর city-শহর council-পরিষদ will-মিলিত হবে meet-মিলিত হবে tomorrow-আগামীকাল] (শহর পরিষদ আগামীকাল মিলিত হবে।)
- Counselor (কাউন্সেলর) - পরামর্শদাতা [Noun] I need to see a counselor. [I-আমার need-দরকার to-দেখতে see-দেখতে a-একজন counselor-পরামর্শদাতার সাথে] (আমার একজন পরামর্শদাতার সাথে দেখা করতে হবে।)
- Count (কাউন্ট) - গণনা করা [Verb] Can you count from 1 to 10? [Can-তুমি কি you-তুমি count-গণনা করতে পারো from-1-এক to-10-দশ পর্যন্ত] (তুমি কি এক থেকে দশ পর্যন্ত গণনা করতে পারো?)
- Counter (কাউন্টার) - কাউন্টার [Noun] I am standing at the counter. [I-আমি am-দাঁড়িয়ে আছি standing-দাঁড়িয়ে আছি at-the-কাউন্টারে counter-কাউন্টার] (আমি কাউন্টারে দাঁড়িয়ে আছি।)
- Country (কান্ট্রি) - দেশ [Noun] I love my country. [I-আমি love-ভালোবাসি my-আমার country-দেশ] (আমি আমার দেশ ভালোবাসি।)
- County (কাউন্টি) - কাউন্টি [Noun] I live in a small county. [I-আমি live-থাকি in-a-একটি small-ছোট county-কাউন্টিতে] (আমি একটি ছোট কাউন্টিতে থাকি।)
- Couple (কাপল) - দম্পতি [Noun] The couple is very happy. [The-দম্পতি couple-দম্পতি is-হয় very-খুব happy-খুশি] (দম্পতি খুব খুশি।)
- Courage (কারেজ) - সাহস [Noun] He has a lot of courage. [He-তার has-আছে a-অনেক lot-অনেক of-এর courage-সাহস] (তার অনেক সাহস আছে।)
- Course (কোর্স) - কোর্স [Noun] I am taking a course on computer science. [I-আমি am-নিচ্ছি taking-নিচ্ছি a-একটি course-কোর্স on-computer-কম্পিউটার science-বিজ্ঞানের উপর] (আমি কম্পিউটার বিজ্ঞানের উপর একটি কোর্স নিচ্ছি।)
- Court (কোর্ট) - আদালত [Noun] The case is in the court. [The-মামলাটি case-মামলা is-আছে in-the-আদালতে court-আদালত] (মামলাটি আদালতে আছে।)
- Cousin (কাজিন) - চাচাতো ভাই/বোন [Noun] He is my cousin. [He-সে is-হয় my-আমার cousin-চাচাতো ভাই] (সে আমার চাচাতো ভাই।)
- Cover (কভার) - ঢাকা [Verb] Please cover the food. [Please-দয়া করে cover-ঢেকে দিন the-খাবার food-খাবার] (দয়া করে খাবার ঢেকে দিন।)
- Cow (কাউ) - গরু [Noun] The cow gives us milk. [The-গরু cow-গরু gives-দেয় us-আমাদের milk-দুধ] (গরু আমাদের দুধ দেয়।)
- Crack (ক্র্যাক) - ফাটল [Noun] There is a crack in the wall. [There-সেখানে is-আছে a-একটি crack-ফাটল in-the-দেয়ালে wall-দেয়াল] (দেয়ালে একটি ফাটল আছে।)
- Craft (ক্র্যাফট) - কারুশিল্প [Noun] I like to do craft work. [I-আমি like-পছন্দ করি to-করতে do-করতে craft-কারুশিল্প work-কাজ] (আমি কারুশিল্পের কাজ করতে পছন্দ করি।)
- Crash (ক্র্যাশ) - দুর্ঘটনা [Noun] There was a car crash on the highway. [There-সেখানে was-হয়েছিল a-একটি car-গাড়ির crash-দুর্ঘটনা on-the-হাইওয়েতে highway-হাইওয়ে] (হাইওয়েতে একটি গাড়ির দুর্ঘটনা হয়েছিল।)
- Crazy (ক্রেজি) - পাগল [Adjective] He is a crazy person. [He-সে is-হয় a-একজন crazy-পাগল person-ব্যক্তি] (সে একজন পাগল ব্যক্তি।)
- Cream (ক্রিম) - ক্রিম [Noun] I like to eat ice cream. [I-আমি like-পছন্দ করি to-খেতে eat-খেতে ice-আইস cream-ক্রিম] (আমি আইসক্রিম খেতে পছন্দ করি।)
- Create (ক্রিয়েট) - তৈরি করা [Verb] I want to create something new. [I-আমি want-চাই to-তৈরি করতে create-তৈরি করতে something-কিছু new-নতুন] (আমি নতুন কিছু তৈরি করতে চাই।)
- Creation (ক্রিয়েশন) - সৃষ্টি [Noun] The creation of the universe is a mystery. [The-সৃষ্টি creation-সৃষ্টি of-এর the-মহাবিশ্বের universe-মহাবিশ্ব is-হয় a-একটি mystery-রহস্য] (মহাবিশ্বের সৃষ্টি একটি রহস্য।)
- Creative (ক্রিয়েটিভ) - সৃজনশীল [Adjective] He is a very creative person. [He-সে is-হয় a-একজন very-খুব creative-সৃজনশীল person-ব্যক্তি] (সে একজন খুব সৃজনশীল ব্যক্তি।)
- Creature (ক্রিয়েচার) - প্রাণী [Noun] There are many strange creatures in the deep sea. [There-সেখানে are-আছে many-অনেক strange-অদ্ভুত creatures-প্রাণী in-the-গভীর deep-গভীর sea-সমুদ্রে] (গভীর সমুদ্রে অনেক অদ্ভুত প্রাণী আছে।)
- Credit (ক্রেডিট) - ক্রেডিট [Noun] I have a good credit score. [I-আমার have-আছে a-একটি good-ভালো credit-ক্রেডিট score-স্কোর] (আমার একটি ভালো ক্রেডিট স্কোর আছে।)
- Crew (ক্রু) - নাবিকদল [Noun] The crew of the ship is very experienced. [The-নাবিকদল crew-নাবিকদল of-এর the-জাহাজটির ship-জাহাজ is-হয় very-খুব experienced-অভিজ্ঞ] (জাহাজটির নাবিকদল খুব অভিজ্ঞ।)
- Crime (ক্রাইম) - অপরাধ [Noun] Theft is a crime. [Theft-চুরি is-হয় a-একটি crime-অপরাধ] (চুরি একটি অপরাধ।)
- Criminal (ক্রিমিনাল) - অপরাধী [Noun] The police arrested the criminal. [The-পুলিশ police-পুলিশ arrested-গ্রেপ্তার করেছে the-অপরাধীকে criminal-অপরাধী] (পুলিশ অপরাধীকে গ্রেপ্তার করেছে।)
- Crisis (ক্রাইসিস) - সংকট [Noun] The country is facing a financial crisis. [The-দেশটি country-দেশ is-মোকাবেলা করছে facing-মোকাবেলা করছে a-একটি financial-আর্থিক crisis-সংকটের] (দেশটি একটি আর্থিক সংকটের মোকাবেলা করছে।)
- Criteria (ক্রাইটেরিয়া) - মানদণ্ড [Noun] What are the criteria for selection? [What-কি are-হয় the-মানদণ্ডগুলো criteria-মানদণ্ড for-জন্য selection-নির্বাচনের] (নির্বাচনের জন্য মানদণ্ডগুলো কি?)
- Critic (ক্রিটিক) - সমালোচক [Noun] He is a famous film critic. [He-তিনি is-হন a-একজন famous-বিখ্যাত film-চলচ্চিত্র critic-সমালোচক] (তিনি একজন বিখ্যাত চলচ্চিত্র সমালোচক।)
- Critical (ক্রিটিক্যাল) - গুরুতর [Adjective] His condition is critical. [His-তার condition-অবস্থা is-হয় critical-গুরুতর] (তার অবস্থা গুরুতর।)
- Criticism (ক্রিটিসিজম) - সমালোচনা [Noun] I am open to criticism. [I-আমি am-উন্মুক্ত open-উন্মুক্ত to-সমালোচনার জন্য criticism-সমালোচনা] (আমি সমালোচনার জন্য উন্মুক্ত।)
- Criticize (ক্রিটিসাইজ) - সমালোচনা করা [Verb] Don't criticize others. [Don't-করো না criticize-সমালোচনা others-অন্যদের] (অন্যদের সমালোচনা করো না।)
- Crop (ক্রপ) - ফসল [Noun] The farmers are harvesting the crop. [The-কৃষকরা farmers-কৃষক are-ফসল কাটছে harvesting-ফসল কাটছে the-ফসল crop-ফসল] (কৃষকরা ফসল কাটছে।)
- Cross (ক্রস) - পার হওয়া [Verb] Be careful when you cross the road. [Be-থাকুন careful-সতর্ক when-যখন you-তুমি cross-পার হও the-রাস্তা road-রাস্তা] (যখন তুমি রাস্তা পার হও তখন সতর্ক থাকুন।)
- Crowd (ক্রাউড) - ভিড় [Noun] There was a large crowd at the concert. [There-সেখানে was-ছিল a-একটি large-বড় crowd-ভিড় at-the-কনসার্টে concert-কনসার্ট] (কনসার্টে একটি বড় ভিড় ছিল।)
- Crucial (ক্রুশিয়াল) - অত্যন্ত গুরুত্বপূর্ণ [Adjective] This is a crucial decision. [This-এটা is-হয় a-একটি crucial-অত্যন্ত গুরুত্বপূর্ণ decision-সিদ্ধান্ত] (এটা একটি অত্যন্ত গুরুত্বপূর্ণ সিদ্ধান্ত।)
- Cruel (ক্রুয়েল) - নিষ্ঠুর [Adjective] He is a cruel person. [He-সে is-হয় a-একজন cruel-নিষ্ঠুর person-ব্যক্তি] (সে একজন নিষ্ঠুর ব্যক্তি।)
- Cruise (ক্রুজ) - সমুদ্রযাত্রা [Noun] We are going on a cruise. [We-আমরা are-যাচ্ছি going-যাচ্ছি on-a-একটি cruise-সমুদ্রযাত্রায়] (আমরা একটি সমুদ্রযাত্রায় যাচ্ছি।)
- Cry (ক্রাই) - কাঁদা [Verb] The baby is crying. [The-শিশুটা baby-শিশু is-কাঁদছে crying-কাঁদছে] (শিশুটা কাঁদছে।)
- Cultural (কালচারাল) - সাংস্কৃতিক [Adjective] This is a cultural event. [This-এটা is-হয় a-একটি cultural-সাংস্কৃতিক event-অনুষ্ঠান] (এটা একটি সাংস্কৃতিক অনুষ্ঠান।)
- Culture (কালচার) - সংস্কৃতি [Noun] I am interested in different cultures. [I-আমি am-আগ্রহী interested-আগ্রহী in-different-বিভিন্ন cultures-সংস্কৃতিতে] (আমি বিভিন্ন সংস্কৃতিতে আগ্রহী।)
- Cup (কাপ) - কাপ [Noun] I need a cup of tea. [I-আমার need-দরকার a-একটি cup-কাপ of-এর tea-চা] (আমার এক কাপ চা দরকার।)
- Curious (কিউরিয়াস) - কৌতূহলী [Adjective] I am curious to know what happened. [I-আমি am-কৌতূহলী curious-কৌতূহলী to-জানতে know-জানতে what-কি happened-ঘটেছে] (আমি জানতে কৌতূহলী যে কি ঘটেছে।)
- Current (কারেন্ট) - বর্তমান [Adjective] What is the current situation? [What-কি is-হয় the-বর্তমান current-বর্তমান situation-পরিস্থিতি] (বর্তমান পরিস্থিতি কি?)
- Currently (কারেন্টলি) - বর্তমানে [Adverb] I am currently unemployed. [I-আমি am-বর্তমানে currently-বর্তমানে unemployed-বেকার] (আমি বর্তমানে বেকার।)
- Curriculum (কারিকুলাম) - পাঠ্যক্রম [Noun] The school has a new curriculum. [The-স্কুলে school-স্কুল has-আছে a-একটি new-নতুন curriculum-পাঠ্যক্রম] (স্কুলে একটি নতুন পাঠ্যক্রম আছে।)
- Curtain (কার্টেন) - পর্দা [Noun] Please draw the curtains. [Please-দয়া করে draw-টানুন the-পর্দাগুলো curtains-পর্দা] (দয়া করে পর্দাগুলো টানুন।)
- Curve (কার্ভ) - বক্ররেখা [Noun] The road has a sharp curve. [The-রাস্তাটিতে road-রাস্তা has-আছে a-একটি sharp-তীক্ষ্ণ curve-বক্ররেখা] (রাস্তাটিতে একটি তীক্ষ্ণ বক্ররেখা আছে।)
- Custody (কাস্টডি) - হেফাজত [Noun] The child is in the custody of his mother. [The-শিশুটা child-শিশু is-আছে in-the-হেফাজতে custody-হেফাজত of-এর his-তার mother-মায়ের] (শিশুটা তার মায়ের হেফাজতে আছে।)
- Custom (কাস্টম) - প্রথা [Noun] This is a local custom. [This-এটা is-হয় a-একটি local-স্থানীয় custom-প্রথা] (এটা একটি স্থানীয় প্রথা।)
- Customer (কাস্টমার) - গ্রাহক [Noun] The customer is always right. [The-গ্রাহক customer-গ্রাহক is-সর্বদা always-সর্বদা right-সঠিক] (গ্রাহক সর্বদা সঠিক।)
- Cut (কাট) - কাটা [Verb] I cut my finger. [I-আমি cut-কেটে ফেলেছি my-আমার finger-আঙুল] (আমি আমার আঙুল কেটে ফেলেছি।)
- Cute (কিউট) - সুন্দর [Adjective] The baby is very cute. [The-শিশুটা baby-শিশু is-হয় very-খুব cute-সুন্দর] (শিশুটা খুব সুন্দর।)
- Cycle (সাইকেল) - চক্র [Noun] The water cycle is a natural process. [The-জল the water-জল cycle-চক্র is-হয় a-একটি natural-প্রাকৃতিক process-প্রক্রিয়া] (জলচক্র একটি প্রাকৃতিক প্রক্রিয়া।)

- Dad (ড্যাড) - বাবা [Noun] My dad is my hero. [My-আমার dad-বাবা is-হন my-আমার hero-বীর] (আমার বাবা আমার বীর।)
- Daily (ডেইলি) - দৈনিক [Adjective] I read the newspaper daily. [I-আমি read-পড়ি the-সংবাদপত্র newspaper-সংবাদপত্র daily-দৈনিক] (আমি দৈনিক সংবাদপত্র পড়ি।)
- Dance (ডান্স) - নাচ [Noun] She loves to dance. [She-সে loves-ভালোবাসে to-নাচতে dance-নাচতে] (সে নাচতে ভালোবাসে।)
- Danger (ডেঞ্জার) - বিপদ [Noun] Stay away from danger. [Stay-থাকুন away-দূরে from-থেকে danger-বিপদ] (বিপদ থেকে দূরে থাকুন।)
- Dark (ডার্ক) - অন্ধকার [Adjective] It is dark outside. [It-এটা is-হয় dark-অন্ধকার outside-বাইরে] (বাইরে অন্ধকার।)
- Date (ডেট) - তারিখ [Noun] What is the date today? [What-কি is-হয় the-তারিখ date-তারিখ today-আজ] (আজ তারিখ কত?)
- Daughter (ডটার) - কন্যা [Noun] She is my daughter. [She-সে is-হয় my-আমার daughter-কন্যা] (সে আমার কন্যা।)
- Day (ডে) - দিন [Noun] Today is a beautiful day. [Today-আজ is-হয় a-একটি beautiful-সুন্দর day-দিন] (আজ একটি সুন্দর দিন।)
- Dead (ডেড) - মৃত [Adjective] The plant is dead. [The-গাছটি plant-গাছ is-হয় dead-মৃত] (গাছটি মৃত।)
- Deal (ডিল) - চুক্তি [Noun] We made a deal. [We-আমরা made-করেছি a-একটি deal-চুক্তি] (আমরা একটি চুক্তি করেছি।)
- Dear (ডিয়ার) - প্রিয় [Adjective] My dear friend, how are you? [My-আমার dear-প্রিয় friend-বন্ধু, how-কেমন are-আছ you-তুমি] (আমার প্রিয় বন্ধু, তুমি কেমন আছ?)
- Death (ডেথ) - মৃত্যু [Noun] Death is inevitable. [Death-মৃত্যু is-হয় inevitable-অনিবার্য] (মৃত্যু অনিবার্য।)
- Debate (ডিবেট) - বিতর্ক [Noun] There was a debate on the new law. [There-সেখানে was-ছিল a-একটি debate-বিতর্ক on-the-নতুন new-নতুন law-আইনের উপর] (নতুন আইনের উপর একটি বিতর্ক ছিল।)
- Decade (ডেকেড) - দশক [Noun] A decade is a period of ten years. [A-একটি decade-দশক is-হয় a-একটি period-সময়কাল of-এর ten-দশ years-বছরের] (একটি দশক হল দশ বছরের একটি সময়কাল।)
- Decide (ডিসাইড) - সিদ্ধান্ত নেওয়া [Verb] I have decided to go. [I-আমি have-নিয়েছি decided-সিদ্ধান্ত to-যাওয়ার go-যাওয়ার] (আমি যাওয়ার সিদ্ধান্ত নিয়েছি।)
- Decision (ডিসিশন) - সিদ্ধান্ত [Noun] It was a difficult decision. [It-এটা was-ছিল a-একটি difficult-কঠিন decision-সিদ্ধান্ত] (এটা একটি কঠিন সিদ্ধান্ত ছিল।)
- Deep (ডীপ) - গভীর [Adjective] The river is very deep. [The-নদীটি river-নদী is-হয় very-খুব deep-গভীর] (নদীটি খুব গভীর।)
- Defeat (ডিফিট) - পরাজয় [Noun] They suffered a heavy defeat. [They-তারা suffered-ভোগ করেছে a-একটি heavy-ভারী defeat-পরাজয়] (তারা একটি ভারী পরাজয় ভোগ করেছে।)
- Defend (ডিফেন্ড) - রক্ষা করা [Verb] The soldiers defended the country. [The-সৈনিকরা soldiers-সৈনিক defended-রক্ষা করেছে the-দেশটি country-দেশ] (সৈনিকরা দেশটি রক্ষা করেছে।)
- Defense (ডিফেন্স) - প্রতিরক্ষা [Noun] The country has a strong defense. [The-দেশটির country-দেশ has-আছে a-একটি strong-শক্তিশালী defense-প্রতিরক্ষা] (দেশটির একটি শক্তিশালী প্রতিরক্ষা আছে।)
- Define (ডিফাইন) - সংজ্ঞায়িত করা [Verb] Can you define this word? [Can-তুমি কি you-তুমি define-সংজ্ঞায়িত করতে পারো this-এই word-শব্দটি] (তুমি কি এই শব্দটি সংজ্ঞায়িত করতে পারো?)
- Degree (ডিগ্রি) - ডিগ্রি [Noun] I have a degree in engineering. [I-আমার have-আছে a-একটি degree-ডিগ্রি in-engineering-প্রকৌশলে] (আমার প্রকৌশলে একটি ডিগ্রি আছে।)
- Delay (ডিলে) - দেরি [Noun] The train was delayed. [The-ট্রেনটি train-ট্রেন was-দেরি হয়েছিল delayed-দেরি] (ট্রেনটি দেরি হয়েছিল।)
- Deliver (ডেলিভার) - পৌঁছে দেওয়া [Verb] The postman delivers the mail. [The-পোস্টম্যান postman-পোস্টম্যান delivers-পৌঁছে দেয় the-চিঠি mail-চিঠি] (পোস্টম্যান চিঠি পৌঁছে দেয়।)
- Demand (ডিমান্ড) - চাহিদা [Noun] There is a high demand for this product. [There-সেখানে is-আছে a-একটি high-উচ্চ demand-চাহিদা for-জন্য this-এই product-পণ্যটির] (এই পণ্যটির জন্য একটি উচ্চ চাহিদা আছে।)
- Democracy (ডেমোক্রেসি) - গণতন্ত্র [Noun] We live in a democracy. [We-আমরা live-বসবাস করি in-a-একটি democracy-গণতন্ত্রে] (আমরা একটি গণতন্ত্রে বসবাস করি।)
- Demonstrate (ডেমোনস্ট্রেট) - প্রদর্শন করা [Verb] He demonstrated how to use the machine. [He-সে demonstrated-প্রদর্শন করেছে how-কিভাবে to-ব্যবহার করতে use-ব্যবহার করতে the-যন্ত্রটি machine-যন্ত্র] (সে কিভাবে যন্ত্রটি ব্যবহার করতে হয় তা প্রদর্শন করেছে।)
- Deny (ডিনাই) - অস্বীকার করা [Verb] He denied the accusation. [He-সে denied-অস্বীকার করেছে the-অভিযোগ accusation-অভিযোগ] (সে অভিযোগ অস্বীকার করেছে।)
- Department (ডিপার্টমেন্ট) - বিভাগ [Noun] I work in the sales department. [I-আমি work-কাজ করি in-the-বিক্রয় sales-বিক্রয় department-বিভাগে] (আমি বিক্রয় বিভাগে কাজ করি।)
- Depend (ডিপেন্ড) - নির্ভর করা [Verb] I depend on you. [I-আমি depend-নির্ভর করি on-you-তোমার উপর] (আমি তোমার উপর নির্ভর করি।)
- Deposit (ডিপোজিট) - জমা [Noun] I made a deposit at the bank. [I-আমি made-করেছি a-একটি deposit-জমা at-the-ব্যাংকে bank-ব্যাংক] (আমি ব্যাংকে একটি জমা করেছি।)
- Depth (ডেপথ) - গভীরতা [Noun] What is the depth of the river? [What-কি is-হয় the-গভীরতা depth-গভীরতা of-এর the-নদীটির river-নদী] (নদীটির গভীরতা কত?)
- Describe (ডেসক্রাইব) - বর্ণনা করা [Verb] Can you describe the thief? [Can-তুমি কি you-তুমি describe-বর্ণনা করতে পারো the-চোরটিকে thief-চোর] (তুমি কি চোরটিকে বর্ণনা করতে পারো?)
- Desert (ডেজার্ট) - মরুভূমি [Noun] The Sahara is a vast desert. [The-সাহারা Sahara-সাহারা is-হয় a-একটি vast-বিশাল desert-মরুভূমি] (সাহারা একটি বিশাল মরুভূমি।)
- Design (ডিজাইন) - নকশা [Noun] I like the design of this dress. [I-আমি like-পছন্দ করি the-নকশা design-নকশা of-এর this-এই dress-পোশাকটির] (আমি এই পোশাকটির নকশা পছন্দ করি।)
- Desire (ডিজায়ার) - ইচ্ছা [Noun] I have a strong desire to travel. [I-আমার have-আছে a-একটি strong-দৃঢ় desire-ইচ্ছা to-ভ্রমণ করার travel-ভ্রমণ] (আমার ভ্রমণ করার একটি দৃঢ় ইচ্ছা আছে।)
- Desk (ডেস্ক) - ডেস্ক [Noun] The book is on the desk. [The-বইটি book-বই is-আছে on-the-ডেস্কে desk-ডেস্ক] (বইটি ডেস্কে আছে।)
- Desperate (ডেসপারেট) - মরিয়া [Adjective] He is desperate for a job. [He-সে is-হয় desperate-মরিয়া for-জন্য a-একটি job-চাকরির] (সে একটি চাকরির জন্য মরিয়া।)
- Despite (ডেসপাইট) - সত্ত্বেও [Preposition] Despite the rain, he went out. [Despite-সত্ত্বেও the-বৃষ্টির rain-বৃষ্টি, he-সে went-গিয়েছিল out-বাইরে] (বৃষ্টি সত্ত্বেও সে বাইরে গিয়েছিল।)
- Destroy (ডেস্ট্রয়) - ধ্বংস করা [Verb] The fire destroyed the building. [The-আগুন fire-আগুন destroyed-ধ্বংস করেছে the-ভবনটি building-ভবন] (আগুন ভবনটি ধ্বংস করেছে।)
- Detail (ডিটেল) - বিস্তারিত [Noun] I need more details. [I-আমার need-দরকার more-আরও details-বিস্তারিত] (আমার আরও বিস্তারিত দরকার।)
- Determine (ডিটারমাইন) - নির্ধারণ করা [Verb] We need to determine the cause of the problem. [We-আমাদের need-দরকার to-নির্ধারণ করতে determine-নির্ধারণ করতে the-কারণ cause-কারণ of-এর the-সমস্যাটির problem-সমস্যা] (আমাদের সমস্যাটির কারণ নির্ধারণ করতে হবে।)
- Develop (ডেভেলপ) - উন্নত করা [Verb] We need to develop our country. [We-আমাদের need-দরকার to-উন্নত করতে develop-উন্নত করতে our-আমাদের country-দেশ] (আমাদের দেশ উন্নত করতে হবে।)
- Development (ডেভেলপমেন্ট) - উন্নয়ন [Noun] The development of the country is very important. [The-উন্নয়ন development-উন্নয়ন of-এর the-দেশটির country-দেশ is-হয় very-খুব important-গুরুত্বপূর্ণ] (দেশটির উন্নয়ন খুব গুরুত্বপূর্ণ।)
- Device (ডিভাইস) - যন্ত্র [Noun] This is a very useful device. [This-এটা is-হয় a-একটি very-খুব useful-দরকারী device-যন্ত্র] (এটা একটি খুব দরকারী যন্ত্র।)
- Die (ডাই) - মারা যাওয়া [Verb] Everyone has to die one day. [Everyone-সবাইকে has-হবে to-মারা যেতে die-মারা যেতে one-এক day-দিন] (সবাইকে একদিন মারা যেতে হবে।)
- Diet (ডায়েট) - খাদ্যতালিকা [Noun] I am on a diet. [I-আমি am-আছি on-a-একটি diet-খাদ্যতালিকায়] (আমি একটি খাদ্যতালিকায় আছি।)
- Difference (ডিফারেন্স) - পার্থক্য [Noun] What is the difference between these two? [What-কি is-হয় the-পার্থক্য difference-পার্থক্য between-these-এই two-দুটির মধ্যে] (এই দুটির মধ্যে পার্থক্য কি?)
- Different (ডিফারেন্ট) - ভিন্ন [Adjective] They have different opinions. [They-তাদের have-আছে different-ভিন্ন opinions-মতামত] (তাদের ভিন্ন মতামত আছে।)
- Difficult (ডিফিকাল্ট) - কঠিন [Adjective] The exam was very difficult. [The-পরীক্ষাটি exam-পরীক্ষা was-ছিল very-খুব difficult-কঠিন] (পরীক্ষাটি খুব কঠিন ছিল।)
- Dig (ডিগ) - খনন করা [Verb] The dog is digging a hole. [The-কুকুরটি dog-কুকুর is-খনন করছে digging-খনন করছে a-একটি hole-গর্ত] (কুকুরটি একটি গর্ত খনন করছে।)
- Digital (ডিজিটাল) - ডিজিটাল [Adjective] We are living in a digital age. [We-আমরা are-বসবাস করছি living-বসবাস করছি in-a-একটি digital-ডিজিটাল age-যুগে] (আমরা একটি ডিজিটাল যুগে বসবাস করছি।)
- Dimension (ডাইমেনশন) - মাত্রা [Noun] The problem has many dimensions. [The-সমস্যাটির problem-সমস্যা has-আছে many-অনেক dimensions-মাত্রা] (সমস্যাটির অনেক মাত্রা আছে।)
- Dinner (ডিনার) - রাতের খাবার [Noun] What are you having for dinner? [What-কি are-খাচ্ছ you-তুমি having-খাচ্ছ for-জন্য dinner-রাতের খাবারে] (তুমি রাতের খাবারে কি খাচ্ছ?)
- Direct (ডাইরেক্ট) - সরাসরি [Adjective] This is a direct flight to London. [This-এটা is-হয় a-একটি direct-সরাসরি flight-ফ্লাইট to-London-লন্ডনে] (এটা লন্ডনে একটি সরাসরি ফ্লাইট।)
- Direction (ডাইরেকশন) - দিক [Noun] Which direction should I go? [Which-কোন direction-দিকে should-উচিত I-আমার go-যাওয়া] (আমার কোন দিকে যাওয়া উচিত?)
- Director (ডাইরেক্টর) - পরিচালক [Noun] He is the director of the company. [He-তিনি is-হন the-পরিচালক director-পরিচালক of-এর the-কোম্পানির company-কোম্পানি] (তিনি কোম্পানির পরিচালক।)
- Dirt (ডার্ট) - ময়লা [Noun] There is a lot of dirt on the floor. [There-সেখানে is-আছে a-অনেক lot-অনেক of-এর dirt-ময়লা on-the-মেঝেতে floor-মেঝে] (মেঝেতে অনেক ময়লা আছে।)
- Disagree (ডিসএগ্রি) - অসম্মত হওয়া [Verb] I disagree with you. [I-আমি disagree-অসম্মতি with-you-তোমার সাথে] (আমি তোমার সাথে অসম্মত।)
- Disappear (ডিসঅ্যাপিয়ার) - অদৃশ্য হওয়া [Verb] The magician made the rabbit disappear. [The-জাদুকর magician-জাদুকর made-করল the-খরগোশটিকে rabbit-খরগোশ disappear-অদৃশ্য] (জাদুকর খরগোশটিকে অদৃশ্য করল।)
- Disaster (ডিজাস্টার) - দুর্যোগ [Noun] The earthquake was a terrible disaster. [The-ভূমিকম্প earthquake-ভূমিকম্প was-ছিল a-একটি terrible-ভয়াবহ disaster-দুর্যোগ] (ভূমিকম্প একটি ভয়াবহ দুর্যোগ ছিল।)
- Discipline (ডিসিপ্লিন) - শৃঙ্খলা [Noun] We need to maintain discipline in the class. [We-আমাদের need-দরকার to-বজায় রাখতে maintain-বজায় রাখতে discipline-শৃঙ্খলা in-the-ক্লাসে class-ক্লাস] (আমাদের ক্লাসে শৃঙ্খলা বজায় রাখতে হবে।)
- Discover (ডিসকভার) - আবিষ্কার করা [Verb] Columbus discovered America. [Columbus-কলম্বাস discovered-আবিষ্কার করেছিলেন America-আমেরিকা] (কলম্বাস আমেরিকা আবিষ্কার করেছিলেন।)
- Discuss (ডিসকাস) - আলোচনা করা [Verb] We need to discuss this matter. [We-আমাদের need-দরকার to-আলোচনা করতে discuss-আলোচনা করতে this-এই matter-বিষয়টি] (আমাদের এই বিষয়টি আলোচনা করতে হবে।)
- Discussion (ডিসকাশন) - আলোচনা [Noun] We had a long discussion. [We-আমরা had-করেছিলাম a-একটি long-দীর্ঘ discussion-আলোচনা] (আমরা একটি দীর্ঘ আলোচনা করেছিলাম।)
- Disease (ডিজিজ) - রোগ [Noun] He is suffering from a rare disease. [He-তিনি is-ভুগছেন suffering-ভুগছেন from-a-একটি rare-বিরল disease-রোগে] (তিনি একটি বিরল রোগে ভুগছেন।)
- Dish (ডিশ) - থালা [Noun] I need a clean dish. [I-আমার need-দরকার a-একটি clean-পরিষ্কার dish-থালা] (আমার একটি পরিষ্কার থালা দরকার।)
- Dismiss (ডিসমিস) - বরখাস্ত করা [Verb] He was dismissed from his job. [He-তাকে was-করা হয়েছিল dismissed-বরখাস্ত from-his-তার job-চাকরি থেকে] (তাকে তার চাকরি থেকে বরখাস্ত করা হয়েছিল।)
- Display (ডিসপ্লে) - প্রদর্শন [Noun] The products are on display. [The-পণ্যগুলো products-পণ্য are-আছে on-display-প্রদর্শনে] (পণ্যগুলো প্রদর্শনে আছে।)
- Distance (ডিস্টেন্স) - দূরত্ব [Noun] What is the distance between the two cities? [What-কি is-হয় the-দূরত্ব distance-দূরত্ব between-the-দুটি two-দুটি cities-শহরের মধ্যে] (দুটি শহরের মধ্যে দূরত্ব কত?)
- Distinct (ডিসটিংক্ট) - স্বতন্ত্র [Adjective] There is a distinct difference between them. [There-সেখানে is-আছে a-একটি distinct-স্বতন্ত্র difference-পার্থক্য between-them-তাদের মধ্যে] (তাদের মধ্যে একটি স্বতন্ত্র পার্থক্য আছে।)
- Distribute (ডিস্ট্রিবিউট) - বিতরণ করা [Verb] Please distribute the books among the students. [Please-দয়া করে distribute-বিতরণ করুন the-বইগুলো books-বই among-the-ছাত্রছাত্রীদের মধ্যে students-ছাত্রছাত্রী] (দয়া করে বইগুলো ছাত্রছাত্রীদের মধ্যে বিতরণ করুন।)
- District (ডিস্ট্রিক্ট) - জেলা [Noun] I live in this district. [I-আমি live-থাকি in-this-এই district-জেলায়] (আমি এই জেলায় থাকি।)
- Divide (ডিভাইড) - ভাগ করা [Verb] Please divide the cake into four pieces. [Please-দয়া করে divide-ভাগ করুন the-কেকটি cake-কেক into-four-চার pieces-টুকরোতে] (দয়া করে কেকটি চার টুকরোতে ভাগ করুন।)
- Division (ডিভিশন) - বিভাগ [Noun] I work in the marketing division. [I-আমি work-কাজ করি in-the-মার্কেটিং marketing-মার্কেটিং division-বিভাগে] (আমি মার্কেটিং বিভাগে কাজ করি।)
- Divorce (ডিভোর্স) - বিবাহবিচ্ছেদ [Noun] They are getting a divorce. [They-তারা are-করছে getting-করছে a-একটি divorce-বিবাহবিচ্ছেদ] (তারা একটি বিবাহবিচ্ছেদ করছে।)
- Do (ডু) - করা [Verb] I have a lot of work to do. [I-আমার have-আছে a-অনেক lot-অনেক of-এর work-কাজ to-করার do-করার] (আমার অনেক কাজ করার আছে।)
- Doctor (ডাক্তার) - ডাক্তার [Noun] I need to see a doctor. [I-আমার need-দরকার to-দেখতে see-দেখতে a-একজন doctor-ডাক্তারের সাথে] (আমার একজন ডাক্তারের সাথে দেখা করতে হবে।)
- Document (ডকুমেন্ট) - নথি [Noun] I need a copy of this document. [I-আমার need-দরকার a-একটি copy-অনুলিপি of-এর this-এই document-নথিটির] (আমার এই নথিটির একটি অনুলিপি দরকার।)
- Dog (ডগ) - কুকুর [Noun] The dog is barking. [The-কুকুরটি dog-কুকুর is-ডাকছে barking-ডাকছে] (কুকুরটি ডাকছে।)
- Doll (ডল) - পুতুল [Noun] The girl is playing with a doll. [The-মেয়েটি girl-মেয়ে is-খেলছে playing-খেলছে with-a-একটি doll-পুতুল দিয়ে] (মেয়েটি একটি পুতুল দিয়ে খেলছে।)
- Dollar (ডলার) - ডলার [Noun] I have ten dollars. [I-আমার have-আছে ten-দশ dollars-ডলার] (আমার দশ ডলার আছে।)
- Domestic (ডোমেস্টিক) - গার্হস্থ্য [Adjective] The dog is a domestic animal. [The-কুকুর dog-কুকুর is-হয় a-একটি domestic-গার্হস্থ্য animal-পশু] (কুকুর একটি গার্হস্থ্য পশু।)
- Dominate (ডমিনেট) - আধিপত্য করা [Verb] He wants to dominate everyone. [He-সে wants-চায় to-আধিপত্য করতে dominate-আধিপত্য করতে everyone-সবার উপর] (সে সবার উপর আধিপত্য করতে চায়।)
- Door (ডোর) - দরজা [Noun] Please open the door. [Please-দয়া করে open-খুলুন the-দরজাটি door-দরজা] (দয়া করে দরজাটি খুলুন।)
- Double (ডাবল) - দ্বিগুণ [Adjective] I want a double scoop of ice cream. [I-আমি want-চাই a-একটি double-দ্বিগুণ scoop-স্কুপ of-এর ice-আইস cream-ক্রিম] (আমি এক স্কুপ আইসক্রিমের দ্বিগুণ চাই।)
- Doubt (ডাউট) - সন্দেহ [Noun] I have no doubt about it. [I-আমার have-নেই no-নেই doubt-সন্দেহ about-it-এটার ব্যাপারে] (এটার ব্যাপারে আমার কোন সন্দেহ নেই।)
- Down (ডাউন) - নিচে [Adverb] He is going down the stairs. [He-সে is-যাচ্ছে going-যাচ্ছে down-নিচে the-সিঁড়ি দিয়ে stairs-সিঁড়ি] (সে সিঁড়ি দিয়ে নিচে যাচ্ছে।)
- Dozen (ডজন) - ডজন [Noun] I bought a dozen eggs. [I-আমি bought-কিনেছি a-একটি dozen-ডজন eggs-ডিম] (আমি এক ডজন ডিম কিনেছি।)
- Draft (ড্রাফট) - খসড়া [Noun] I have prepared a draft of the letter. [I-আমি have-তৈরি করেছি prepared-তৈরি করেছি a-একটি draft-খসড়া of-এর the-চিঠিটির letter-চিঠি] (আমি চিঠিটির একটি খসড়া তৈরি করেছি।)
- Drag (ড্র্যাগ) - টেনে আনা [Verb] He dragged the chair across the room. [He-সে dragged-টেনে আনল the-চেয়ারটি chair-চেয়ার across-the-ঘরের মধ্যে room-ঘর] (সে ঘরের মধ্যে চেয়ারটি টেনে আনল।)
- Drama (ড্রামা) - নাটক [Noun] I like to watch drama. [I-আমি like-পছন্দ করি to-দেখতে watch-দেখতে drama-নাটক] (আমি নাটক দেখতে পছন্দ করি।)
- Dramatic (ড্রামাটিক) - নাটকীয় [Adjective] The ending of the movie was very dramatic. [The-শেষ the ending-শেষ of-এর the-চলচ্চিত্রটির movie-চলচ্চিত্র was-ছিল very-খুব dramatic-নাটকীয়] (চলচ্চিত্রটির শেষ খুব নাটকীয় ছিল।)
- Draw (ড্র) - আঁকা [Verb] I like to draw pictures. [I-আমি like-পছন্দ করি to-আঁকতে draw-আঁকতে pictures-ছবি] (আমি ছবি আঁকতে পছন্দ করি।)
- Dream (ড্রীম) - স্বপ্ন [Noun] I had a strange dream last night. [I-আমি had-দেখেছিলাম a-একটি strange-অদ্ভুত dream-স্বপ্ন last-গত night-রাতে] (আমি গত রাতে একটি অদ্ভুত স্বপ্ন দেখেছিলাম।)
- Dress (ড্রেস) - পোশাক [Noun] I need a new dress for the party. [I-আমার need-দরকার a-একটি new-নতুন dress-পোশাক for-জন্য the-পার্টিটির party-পার্টি] (আমার পার্টিটির জন্য একটি নতুন পোশাক দরকার।)
- Drink (ড্রিঙ্ক) - পান করা [Verb] I want to drink some water. [I-আমি want-চাই to-পান করতে drink-পান করতে some-কিছু water-জল] (আমি কিছু জল পান করতে চাই।)
- Drive (ড্রাইভ) - চালানো [Verb] I am learning to drive a car. [I-আমি am-শিখছি learning-শিখছি to-চালাতে drive-চালাতে a-একটি car-গাড়ি] (আমি একটি গাড়ি চালাতে শিখছি।)
- Driver (ড্রাইভার) - চালক [Noun] The driver is driving the car. [The-চালক driver-চালক is-চালাচ্ছে driving-চালাচ্ছে the-গাড়িটি car-গাড়ি] (চালক গাড়িটি চালাচ্ছে।)
- Drop (ড্রপ) - ফেলে দেওয়া [Verb] Be careful, don't drop the glass. [Be-থাকুন careful-সতর্ক, don't-ফেলে দিও না drop-ফেলে দিও the-গ্লাসটি glass-গ্লাস] (সতর্ক থাকুন, গ্লাসটি ফেলে দিও না।)
- Drug (ড্রাগ) - ঔষধ [Noun] He is addicted to drugs. [He-সে is-আসক্ত addicted-আসক্ত to-drugs-ঔষধের প্রতি] (সে ঔষধের প্রতি আসক্ত।)
- Dry (ড্রাই) - শুকনো [Adjective] The clothes are dry now. [The-পোশাকগুলো clothes-পোশাক are-শুকনো dry-শুকনো now-এখন] (পোশাকগুলো এখন শুকনো।)
- Due (ডিউ) - কারণে [Adjective] The game was cancelled due to rain. [The-খেলাটি game-খেলা was-বাতিল হয়েছিল cancelled-বাতিল due-কারণে to-rain-বৃষ্টির] (বৃষ্টির কারণে খেলাটি বাতিল হয়েছিল।)
- During (ডিউরিং) - সময় [Preposition] I will be busy during the day. [I-আমি will-থাকব be-থাকব busy-ব্যস্ত during-সময় the-দিনের day-দিন] (আমি দিনের বেলায় ব্যস্ত থাকব।)
- Dust (ডাস্ট) - ধুলো [Noun] There is a lot of dust on the table. [There-সেখানে is-আছে a-অনেক lot-অনেক of-এর dust-ধুলো on-the-টেবিলের উপর table-টেবিল] (টেবিলের উপর অনেক ধুলো আছে।)
- Duty (ডিউটি) - কর্তব্য [Noun] It is my duty to help you. [It-এটা is-হয় my-আমার duty-কর্তব্য to-সাহায্য করা help-সাহায্য করা you-তোমাকে] (তোমাকে সাহায্য করা আমার কর্তব্য।)

- Eagle (ঈগল) - ঈগল [Noun] The eagle is a large bird. [The-ঈগল eagle-ঈগল is-হয় a-একটি large-বড় bird-পাখি] (ঈগল একটি বড় পাখি।)
- Ear (ইয়ার) - কান [Noun] I have two ears. [I-আমার have-আছে two-দুটি ears-কান] (আমার দুটি কান আছে।)
- Early (আর্লি) - তাড়াতাড়ি [Adverb] I wake up early in the morning. [I-আমি wake-জেগে উঠি up-উঠি early-তাড়াতাড়ি in-the-সকালে morning-সকাল] (আমি সকালে তাড়াতাড়ি জেগে উঠি।)
- Earn (আর্ন) - উপার্জন করা [Verb] I need to earn more money. [I-আমার need-দরকার to-উপার্জন করতে earn-উপার্জন করতে more-আরও money-টাকা] (আমার আরও টাকা উপার্জন করতে হবে।)
- Earth (আর্থ) - পৃথিবী [Noun] We live on the Earth. [We-আমরা live-বসবাস করি on-the-পৃথিবীতে Earth-পৃথিবী] (আমরা পৃথিবীতে বসবাস করি।)
- East (ঈস্ট) - পূর্ব [Noun] The sun rises in the east. [The-সূর্য sun-সূর্য rises-ওঠে in-the-পূর্বে east-পূর্ব] (সূর্য পূর্বে ওঠে।)
- Easy (ইজি) - সহজ [Adjective] The exam was very easy. [The-পরীক্ষাটি exam-পরীক্ষা was-ছিল very-খুব easy-সহজ] (পরীক্ষাটি খুব সহজ ছিল।)
- Eat (ঈট) - খাওয়া [Verb] I like to eat fruits. [I-আমি like-পছন্দ করি to-খেতে eat-খেতে fruits-ফল] (আমি ফল খেতে পছন্দ করি।)
- Echo (ইকো) - প্রতিধ্বনি [Noun] I can hear an echo. [I-আমি can-শুনতে পাচ্ছি hear-শুনতে an-একটি echo-প্রতিধ্বনি] (আমি একটি প্রতিধ্বনি শুনতে পাচ্ছি।)
- Edge (এজ) - ধার [Noun] The knife has a sharp edge. [The-ছুরিটির knife-ছুরি has-আছে a-একটি sharp-ধারালো edge-ধার] (ছুরিটির একটি ধারালো ধার আছে।)
- Educate (এডুকেট) - শিক্ষিত করা [Verb] We need to educate our children. [We-আমাদের need-দরকার to-শিক্ষিত করতে educate-শিক্ষিত করতে our-আমাদের children-শিশুদের] (আমাদের শিশুদের শিক্ষিত করতে হবে।)
- Effect (ইফেক্ট) - প্রভাব [Noun] The medicine had a good effect. [The-ঔষধটির medicine-ঔষধ had-ছিল a-একটি good-ভালো effect-প্রভাব] (ঔষধটির একটি ভালো প্রভাব ছিল।)
- Effort (এফোর্ট) - প্রচেষ্টা [Noun] We need to make more effort. [We-আমাদের need-দরকার to-করতে make-করতে more-আরও effort-প্রচেষ্টা] (আমাদের আরও প্রচেষ্টা করতে হবে।)
- Egg (এগ) - ডিম [Noun] I eat an egg every day. [I-আমি eat-খাই an-একটি egg-ডিম every-প্রতি day-দিন] (আমি প্রতিদিন একটি ডিম খাই।)
- Eight (এইট) - আট [Number] I have eight pencils. [I-আমার have-আছে eight-আটটি pencils-পেন্সিল] (আমার আটটি পেন্সিল আছে।)
- Either (আইদার) - হয় [Conjunction] You can either stay or go. [You-তুমি can-পারো either-হয় stay-থাকতে or-অথবা go-যেতে] (তুমি হয় থাকতে পারো অথবা যেতে পারো।)
- Elbow (এলবো) - কনুই [Noun] I hurt my elbow. [I-আমি hurt-আঘাত পেয়েছি my-আমার elbow-কনুইতে] (আমি আমার কনুইতে আঘাত পেয়েছি।)
- Elder (এল্ডার) - বড় [Adjective] My elder brother is a doctor. [My-আমার elder-বড় brother-ভাই is-হন a-একজন doctor-ডাক্তার] (আমার বড় ভাই একজন ডাক্তার।)
- Elect (ইলেক্ট) - নির্বাচিত করা [Verb] We will elect a new president. [We-আমরা will-করব elect-নির্বাচিত a-একজন new-নতুন president-রাষ্ট্রপতি] (আমরা একজন নতুন রাষ্ট্রপতি নির্বাচিত করব।)
- Electric (ইলেকট্রিক) - বৈদ্যুতিক [Adjective] This is an electric car. [This-এটা is-হয় an-একটি electric-বৈদ্যুতিক car-গাড়ি] (এটা একটি বৈদ্যুতিক গাড়ি।)
- Elephant (এলিফ্যান্ট) - হাতি [Noun] The elephant is a huge animal. [The-হাতি elephant-হাতি is-হয় a-একটি huge-বিশাল animal-পশু] (হাতি একটি বিশাল পশু।)
- Eleven (ইলেভেন) - এগারো [Number] There are eleven players in a cricket team. [There-সেখানে are-আছে eleven-এগারোজন players-খেলোয়াড় in-a-একটি cricket-ক্রিকেট team-দলে] (একটি ক্রিকেট দলে এগারোজন খেলোয়াড় আছে।)
- Else (এলস) - অন্য [Adverb] What else do you want? [What-আর else-কি do-তুমি you-তুমি want-চাও] (তুমি আর কি চাও?)
- Embarrass (এমব্যারাস) - বিব্রত করা [Verb] Don't embarrass me. [Don't-করো না embarrass-বিব্রত me-আমাকে] (আমাকে বিব্রত করো না।)
- Emerge (ইমার্জ) - আবির্ভূত হওয়া [Verb] The sun emerged from behind the clouds. [The-সূর্য sun-সূর্য emerged-আবির্ভূত হল from-behind-পিছন থেকে the-মেঘের clouds-মেঘ] (সূর্য মেঘের পিছন থেকে আবির্ভূত হল।)
- Emergency (ইমার্জেন্সি) - জরুরি অবস্থা [Noun] This is an emergency. [This-এটা is-হয় an-একটি emergency-জরুরি অবস্থা] (এটা একটি জরুরি অবস্থা।)
- Emotion (ইমোশন) - আবেগ [Noun] He is a man of strong emotions. [He-তিনি is-হন a-একজন man-মানুষ of-এর strong-দৃঢ় emotions-আবেগের] (তিনি একজন দৃঢ় আবেগের মানুষ।)
- Emphasize (এমফাসাইজ) - জোর দেওয়া [Verb] I want to emphasize this point. [I-আমি want-চাই to-জোর দিতে emphasize-জোর দিতে this-এই point-বিষয়টির উপর] (আমি এই বিষয়টির উপর জোর দিতে চাই।)
- Empire (এম্পায়ার) - সাম্রাজ্য [Noun] The Roman Empire was very powerful. [The-রোমান Roman-রোমান Empire-সাম্রাজ্য was-ছিল very-খুব powerful-শক্তিশালী] (রোমান সাম্রাজ্য খুব শক্তিশালী ছিল।)
- Employ (এমপ্লয়) - নিয়োগ করা [Verb] The company will employ more people. [The-কোম্পানি company-কোম্পানি will-করবে employ-নিয়োগ more-আরও people-লোক] (কোম্পানি আরও লোক নিয়োগ করবে।)
- Empty (এমপ্টি) - খালি [Adjective] The bottle is empty. [The-বোতলটি bottle-বোতল is-হয় empty-খালি] (বোতলটি খালি।)
- Encourage (এনকারেজ) - উৎসাহিত করা [Verb] We should encourage our children. [We-আমাদের should-উচিত encourage-উৎসাহিত করা our-আমাদের children-শিশুদের] (আমাদের শিশুদের উৎসাহিত করা উচিত।)
- End (এন্ড) - শেষ [Noun] This is the end of the story. [This-এটা is-হয় the-শেষ end-শেষ of-এর the-গল্পটির story-গল্প] (এটা গল্পটির শেষ।)
- Enemy (এনিমি) - শত্রু [Noun] He is my enemy. [He-সে is-হয় my-আমার enemy-শত্রু] (সে আমার শত্রু।)
- Energy (এনার্জি) - শক্তি [Noun] I have no energy to work. [I-আমার have-নেই no-নেই energy-শক্তি to-কাজ করার work-কাজ] (আমার কাজ করার শক্তি নেই।)
- Engage (এনগেজ) - নিযুক্ত থাকা [Verb] I am engaged in a project. [I-আমি am-নিযুক্ত আছি engaged-নিযুক্ত in-a-একটি project-প্রকল্পে] (আমি একটি প্রকল্পে নিযুক্ত আছি।)
- Engine (엔진) - ইঞ্জিন [Noun] The car has a powerful engine. [The-গাড়িটির car-গাড়ি has-আছে a-একটি powerful-শক্তিশালী engine-ইঞ্জিন] (গাড়িটির একটি শক্তিশালী ইঞ্জিন আছে।)
- Engineer (ইঞ্জিনিয়ার) - প্রকৌশলী [Noun] My father is an engineer. [My-আমার father-বাবা is-হন an-একজন engineer-প্রকৌশলী] (আমার বাবা একজন প্রকৌশলী।)
- English (ইংলিশ) - ইংরেজি [Noun] I am learning English. [I-আমি am-শিখছি learning-শিখছি English-ইংরেজি] (আমি ইংরেজি শিখছি।)
- Enjoy (এনজয়) - উপভোগ করা [Verb] I enjoy listening to music. [I-আমি enjoy-উপভোগ করি listening-শুনতে to-music-গান] (আমি গান শুনতে উপভোগ করি।)
- Enormous (ইнорমাস) - বিশাল [Adjective] The elephant is an enormous animal. [The-হাতি elephant-হাতি is-হয় an-একটি enormous-বিশাল animal-পশু] (হাতি একটি বিশাল পশু।)
- Enough (ইনাফ) - যথেষ্ট [Adverb] I have had enough to eat. [I-আমি have-খেয়েছি had-খেয়েছি enough-যথেষ্ট to-eat-খাওয়ার] (আমি যথেষ্ট খেয়েছি।)
- Ensure (এনশিওর) - নিশ্চিত করা [Verb] Please ensure that the door is locked. [Please-দয়া করে ensure-নিশ্চিত করুন that-যে the-দরজাটি door-দরজা is-বন্ধ locked-বন্ধ] (দয়া করে নিশ্চিত করুন যে দরজাটি বন্ধ আছে।)
- Enter (এন্টার) - প্রবেশ করা [Verb] Please enter the room. [Please-দয়া করে enter-প্রবেশ করুন the-ঘরে room-ঘর] (দয়া করে ঘরে প্রবেশ করুন।)
- Enterprise (এন্টারপ্রাইজ) - প্রতিষ্ঠান [Noun] He has a large enterprise. [He-তার has-আছে a-একটি large-বড় enterprise-প্রতিষ্ঠান] (তার একটি বড় প্রতিষ্ঠান আছে।)
- Entertainment (এন্টারটেইনমেন্ট) - বিনোদন [Noun] The movie was a great entertainment. [The-চলচ্চিত্রটি movie-চলচ্চিত্র was-ছিল a-একটি great-চমৎকার entertainment-বিনোদন] (চলচ্চিত্রটি একটি চমৎকার বিনোদন ছিল।)
- Entire (এনটায়ার) - সম্পূর্ণ [Adjective] I have read the entire book. [I-আমি have-পড়েছি read-পড়েছি the-সম্পূর্ণ entire-সম্পূর্ণ book-বইটি] (আমি সম্পূর্ণ বইটি পড়েছি।)
- Entrance (এন্ট্রান্স) - প্রবেশদ্বার [Noun] This is the main entrance of the building. [This-এটা is-হয় the-প্রধান main-প্রধান entrance-প্রবেশদ্বার of-এর the-ভবনটির building-ভবন] (এটা ভবনটির প্রধান প্রবেশদ্বার।)
- Envelope (এনভেলপ) - খাম [Noun] I need an envelope. [I-আমার need-দরকার an-একটি envelope-খাম] (আমার একটি খাম দরকার।)
- Environment (এনভায়রনমেন্ট) - পরিবেশ [Noun] We should protect our environment. [We-আমাদের should-উচিত protect-রক্ষা করা our-আমাদের environment-পরিবেশ] (আমাদের পরিবেশ রক্ষা করা উচিত।)
- Equal (ইকুয়াল) - সমান [Adjective] All men are equal. [All-সব men-মানুষ are-হয় equal-সমান] (সব মানুষ সমান।)
- Equipment (ইকুইপমেন্ট) - সরঞ্জাম [Noun] We need some new equipment. [We-আমাদের need-দরকার some-কিছু new-নতুন equipment-সরঞ্জাম] (আমাদের কিছু নতুন সরঞ্জাম দরকার।)
- Era (ইরা) - যুগ [Noun] We are living in a new era. [We-আমরা are-বসবাস করছি living-বসবাস করছি in-a-একটি new-নতুন era-যুগে] (আমরা একটি নতুন যুগে বসবাস করছি।)
- Error (এরর) - ভুল [Noun] There is an error in this calculation. [There-সেখানে is-আছে an-একটি error-ভুল in-this-এই calculation-গণনায়] (এই গণনায় একটি ভুল আছে।)
- Escape (এসকেপ) - পালানো [Verb] The prisoner tried to escape. [The-বন্দী prisoner-বন্দী tried-চেষ্টা করেছিল to-পালাতে escape-পালাতে] (বন্দীটি পালাতে চেষ্টা করেছিল।)
- Especially (এস্পেশালি) - বিশেষভাবে [Adverb] I like all fruits, especially mangoes. [I-আমি like-পছন্দ করি all-সব fruits-ফল, especially-বিশেষভাবে mangoes-আম] (আমি সব ফল পছন্দ করি, বিশেষভাবে আম।)
- Essay (এসে) - প্রবন্ধ [Noun] I have to write an essay. [I-আমাকে have-করতে হবে to-লিখতে write-লিখতে an-একটি essay-প্রবন্ধ] (আমাকে একটি প্রবন্ধ লিখতে হবে।)
- Essential (এসেনশিয়াল) - অপরিহার্য [Adjective] Water is essential for life. [Water-জল is-হয় essential-অপরিহার্য for-জন্য life-জীবনের] (জল জীবনের জন্য অপরিহার্য।)
- Establish (এস্টাবলিশ) - প্রতিষ্ঠা করা [Verb] He established a new company. [He-তিনি established-প্রতিষ্ঠা করেছেন a-একটি new-নতুন company-কোম্পানি] (তিনি একটি নতুন কোম্পানি প্রতিষ্ঠা করেছেন।)
- Estate (এস্টেট) - সম্পত্তি [Noun] He has a large estate. [He-তার has-আছে a-একটি large-বড় estate-সম্পত্তি] (তার একটি বড় সম্পত্তি আছে।)
- Estimate (এস্টিমেট) - অনুমান [Noun] What is your estimate of the cost? [What-কি is-হয় your-তোমার estimate-অনুমান of-এর the-খরচের cost-খরচ] (খরচের তোমার অনুমান কি?)
- Ethnic (এথনিক) - জাতিগত [Adjective] There are many ethnic groups in this country. [There-সেখানে are-আছে many-অনেক ethnic-জাতিগত groups-গোষ্ঠী in-this-এই country-দেশে] (এই দেশে অনেক জাতিগত গোষ্ঠী আছে।)
- Even (ইভেন) - এমনকি [Adverb] Even a child can do it. [Even-এমনকি a-একটি child-শিশু can-পারে do-করতে it-এটা] (এমনকি একটি শিশুও এটা করতে পারে।)
- Evening (ইভনিং) - সন্ধ্যা [Noun] I will meet you in the evening. [I-আমি will-করব meet-দেখা you-তোমার সাথে in-the-সন্ধ্যায় evening-সন্ধ্যা] (আমি তোমার সাথে সন্ধ্যায় দেখা করব।)
- Event (ইভেন্ট) - ঘটনা [Noun] The wedding was a big event. [The-বিবাহ wedding-বিবাহ was-ছিল a-একটি big-বড় event-ঘটনা] (বিবাহ একটি বড় ঘটনা ছিল।)
- Eventually (ইভেনচুয়ালি) - অবশেষে [Adverb] He eventually agreed to help. [He-সে eventually-অবশেষে agreed-রাজি হল to-সাহায্য করতে help-সাহায্য করতে] (সে অবশেষে সাহায্য করতে রাজি হল।)
- Ever (এভার) - কখনও [Adverb] Have you ever been to London? [Have-তুমি কি you-তুমি ever-কখনও been-গিয়েছ to-London-লন্ডনে] (তুমি কি কখনও লন্ডনে গিয়েছ?)
- Every (এভরি) - প্রত্যেক [Determiner] Every student has a book. [Every-প্রত্যেক student-ছাত্রের has-আছে a-একটি book-বই] (প্রত্যেক ছাত্রের একটি বই আছে।)
- Everybody (এভরিবডি) - সবাই [Pronoun] Everybody is happy. [Everybody-সবাই is-হয় happy-খুশি] (সবাই খুশি।)
- Everyday (এভরিডে) - প্রতিদিন [Adjective] This is an everyday occurrence. [This-এটা is-হয় an-একটি everyday-প্রতিদিনের occurrence-ঘটনা] (এটা একটি প্রতিদিনের ঘটনা।)
- Everyone (এভরিওয়ান) - সবাই [Pronoun] Everyone is invited to the party. [Everyone-সবাই is-আমন্ত্রিত invited-আমন্ত্রিত to-the-পার্টিতে party-পার্টি] (সবাই পার্টিতে আমন্ত্রিত।)
- Everything (এভরিথিং) - সবকিছু [Pronoun] Everything is ready. [Everything-সবকিছু is-হয় ready-প্রস্তুত] (সবকিছু প্রস্তুত।)
- Everywhere (এভরিহোয়্যার) - সর্বত্র [Adverb] I have looked everywhere. [I-আমি have-দেখেছি looked-দেখেছি everywhere-সর্বত্র] (আমি সর্বত্র দেখেছি।)
- Evidence (এভিডেন্স) - প্রমাণ [Noun] There is no evidence against him. [There-সেখানে is-নেই no-নেই evidence-প্রমাণ against-him-তার বিরুদ্ধে] (তার বিরুদ্ধে কোন প্রমাণ নেই।)
- Evil (ইভিল) - মন্দ [Adjective] He is an evil person. [He-সে is-হয় an-একজন evil-মন্দ person-ব্যক্তি] (সে একজন মন্দ ব্যক্তি।)
- Exact (এক্সাক্ট) - সঠিক [Adjective] What is the exact time? [What-কি is-হয় the-সঠিক exact-সঠিক time-সময়] (সঠিক সময় কি?)
- Exactly (এক্সাক্টলি) - ঠিক [Adverb] That is exactly what I wanted. [That-ওটা is-হয় exactly-ঠিক what-যা I-আমি wanted-চেয়েছিলাম] (ওটা ঠিক যা আমি চেয়েছিলাম।)
- Exam (এক্সাম) - পরীক্ষা [Noun] I have an exam tomorrow. [I-আমার have-আছে an-একটি exam-পরীক্ষা tomorrow-আগামীকাল] (আমার আগামীকাল একটি পরীক্ষা আছে।)
- Examine (এক্সামিন) - পরীক্ষা করা [Verb] The doctor will examine you. [The-ডাক্তার doctor-ডাক্তার will-করবেন examine-পরীক্ষা you-তোমাকে] (ডাক্তার তোমাকে পরীক্ষা করবেন।)
- Example (এক্সাম্পল) - উদাহরণ [Noun] Can you give me an example? [Can-তুমি কি you-তুমি give-দিতে পারো me-আমাকে an-একটি example-উদাহরণ] (তুমি কি আমাকে একটি উদাহরণ দিতে পারো?)
- Excellent (এক্সেলেন্ট) - চমৎকার [Adjective] The food was excellent. [The-খাবার food-খাবার was-ছিল excellent-চমৎকার] (খাবার চমৎকার ছিল।)
- Except (এক্সেপ্ট) - ছাড়া [Preposition] Everyone was present except him. [Everyone-সবাই was-ছিল present-উপস্থিত except-ছাড়া him-সে] (সে ছাড়া সবাই উপস্থিত ছিল।)
- Exchange (এক্সচেঞ্জ) - বিনিময় [Noun] I want to exchange this shirt. [I-আমি want-চাই to-বিনিময় করতে exchange-বিনিময় করতে this-এই shirt-শার্টটি] (আমি এই শার্টটি বিনিময় করতে চাই।)
- Excite (এক্সাইট) - উত্তেজিত করা [Verb] The news will excite you. [The-খবরটি news-খবর will-করবে excite-উত্তেজিত you-তোমাকে] (খবরটি তোমাকে উত্তেজিত করবে।)
- Exciting (এক্সাইটিং) - উত্তেজনাপূর্ণ [Adjective] The game was very exciting. [The-খেলাটি game-খেলা was-ছিল very-খুব exciting-উত্তেজনাপূর্ণ] (খেলাটি খুব উত্তেজনাপূর্ণ ছিল।)
- Excuse (এক্সকিউজ) - অজুহাত [Noun] What is your excuse? [What-কি is-হয় your-তোমার excuse-অজুহাত] (তোমার অজুহাত কি?)
- Executive (এক্সিকিউটিভ) - নির্বাহী [Noun] He is a senior executive in the company. [He-তিনি is-হন a-একজন senior-সিনিয়র executive-নির্বাহী in-the-কোম্পানিতে company-কোম্পানি] (তিনি কোম্পানিতে একজন সিনিয়র নির্বাহী।)
- Exercise (এক্সারসাইজ) - ব্যায়াম [Noun] I do exercise every day. [I-আমি do-করি exercise-ব্যায়াম every-প্রতি day-দিন] (আমি প্রতিদিন ব্যায়াম করি।)
- Exhibit (এক্সজিবিট) - প্রদর্শন করা [Verb] They will exhibit their paintings. [They-তারা will-করবে exhibit-প্রদর্শন their-তাদের paintings-চিত্রকর্ম] (তারা তাদের চিত্রকর্ম প্রদর্শন করবে।)
- Exhibition (এক্সজিবিশন) - প্রদর্শনী [Noun] I am going to an art exhibition. [I-আমি am-যাচ্ছি going-যাচ্ছি to-an-একটি art-শিল্প exhibition-প্রদর্শনীতে] (আমি একটি শিল্প প্রদর্শনীতে যাচ্ছি।)
- Exist (এক্সিস্ট) - বিদ্যমান থাকা [Verb] Do you believe that ghosts exist? [Do-তুমি কি you-তুমি believe-বিশ্বাস কর that-যে ghosts-ভূত exist-বিদ্যমান আছে] (তুমি কি বিশ্বাস কর যে ভূত বিদ্যমান আছে?)
- Existence (এক্সিস্টেন্স) - অস্তিত্ব [Noun] The existence of God is a matter of faith. [The-অস্তিত্ব existence-অস্তিত্ব of-এর God-ঈশ্বরের is-হয় a-একটি matter-বিষয় of-এর faith-বিশ্বাসের] (ঈশ্বরের অস্তিত্ব বিশ্বাসের একটি বিষয়।)
- Expand (এক্সপ্যান্ড) - প্রসারিত করা [Verb] We need to expand our business. [We-আমাদের need-দরকার to-প্রসারিত করতে expand-প্রসারিত করতে our-আমাদের business-ব্যবসা] (আমাদের ব্যবসা প্রসারিত করতে হবে।)
- Expect (এক্সপেক্ট) - আশা করা [Verb] I expect you to be on time. [I-আমি expect-আশা করি you-তুমি to-থাকবে be-থাকবে on-time-সময়মতো] (আমি আশা করি তুমি সময়মতো থাকবে।)
- Expectation (এক্সপেক্টেশন) - প্রত্যাশা [Noun] My expectations are very high. [My-আমার expectations-প্রত্যাশা are-হয় very-খুব high-উচ্চ] (আমার প্রত্যাশা খুব উচ্চ।)
- Expense (এক্সপেন্স) - খরচ [Noun] We need to reduce our expenses. [We-আমাদের need-দরকার to-কমাতে reduce-কমাতে our-আমাদের expenses-খরচ] (আমাদের খরচ কমাতে হবে।)
- Expensive (এক্সপেনসিভ) - ব্যয়বহুল [Adjective] This car is very expensive. [This-এই car-গাড়িটি is-হয় very-খুব expensive-ব্যয়বহুল] (এই গাড়িটি খুব ব্যয়বহুল।)
- Experience (এক্সপেরিয়েন্স) - অভিজ্ঞতা [Noun] I have a lot of experience in this field. [I-আমার have-আছে a-অনেক lot-অনেক of-এর experience-অভিজ্ঞতা in-this-এই field-ক্ষেত্রে] (আমার এই ক্ষেত্রে অনেক অভিজ্ঞতা আছে।)
- Experiment (এক্সপেরিমেন্ট) - পরীক্ষা [Noun] We are doing an experiment. [We-আমরা are-করছি doing-করছি an-একটি experiment-পরীক্ষা] (আমরা একটি পরীক্ষা করছি।)
- Expert (এক্সপার্ট) - বিশেষজ্ঞ [Noun] He is an expert in this field. [He-তিনি is-হন an-একজন expert-বিশেষজ্ঞ in-this-এই field-ক্ষেত্রে] (তিনি এই ক্ষেত্রে একজন বিশেষজ্ঞ।)
- Explain (এক্সপ্লেইন) - ব্যাখ্যা করা [Verb] Can you explain this to me? [Can-তুমি কি you-তুমি explain-ব্যাখ্যা করতে পারো this-এটা to-me-আমাকে] (তুমি কি আমাকে এটা ব্যাখ্যা করতে পারো?)
- Explode (এক্সপ্লোড) - বিস্ফোরিত হওয়া [Verb] The bomb exploded. [The-বোমাটি bomb-বোমা exploded-বিস্ফোরিত হল] (বোমাটি বিস্ফোরিত হল।)
- Explore (এক্সপ্লোর) - অন্বেষণ করা [Verb] I want to explore the world. [I-আমি want-চাই to-অন্বেষণ করতে explore-অন্বেষণ করতে the-বিশ্ব world-বিশ্ব] (আমি বিশ্ব অন্বেষণ করতে চাই।)
- Explosion (এক্সপ্লোশন) - বিস্ফোরণ [Noun] There was a loud explosion. [There-সেখানে was-ছিল a-একটি loud-জোরালো explosion-বিস্ফোরণ] (সেখানে একটি জোরালো বিস্ফোরণ ছিল।)
- Export (এক্সপোর্ট) - রপ্তানি করা [Verb] We export tea to other countries. [We-আমরা export-রপ্তানি করি tea-চা to-other-অন্য countries-দেশে] (আমরা অন্য দেশে চা রপ্তানি করি।)
- Expose (এক্সপোজ) - প্রকাশ করা [Verb] He was exposed as a spy. [He-তাকে was-করা হয়েছিল exposed-প্রকাশ as-a-একজন spy-গুপ্তচর হিসাবে] (তাকে একজন গুপ্তচর হিসাবে প্রকাশ করা হয়েছিল।)
- Express (এক্সপ্রেস) - প্রকাশ করা [Verb] I want to express my feelings. [I-আমি want-চাই to-প্রকাশ করতে express-প্রকাশ করতে my-আমার feelings-অনুভূতি] (আমি আমার অনুভূতি প্রকাশ করতে চাই।)
- Expression (এক্সপ্রেশন) - অভিব্যক্তি [Noun] He has a sad expression on his face. [He-তার has-আছে a-একটি sad-দুঃখী expression-অভিব্যক্তি on-his-তার face-মুখে] (তার মুখে একটি দুঃখী অভিব্যক্তি আছে।)
- Extend (এক্সটেন্ড) - বাড়ানো [Verb] We need to extend the deadline. [We-আমাদের need-দরকার to-বাড়াতে extend-বাড়াতে the-সময়সীমা deadline-সময়সীমা] (আমাদের সময়সীমা বাড়াতে হবে।)
- Extension (এক্সটেনশন) - সম্প্রসারণ [Noun] I need an extension for my visa. [I-আমার need-দরকার an-একটি extension-সম্প্রসারণ for-my-আমার visa-ভিসার জন্য] (আমার ভিসার জন্য একটি সম্প্রসারণ দরকার।)
- Extensive (এক্সটেনসিভ) - ব্যাপক [Adjective] He has extensive knowledge of the subject. [He-তার has-আছে extensive-ব্যাপক knowledge-জ্ঞান of-the-বিষয়টির subject-বিষয়] (তার বিষয়টির উপর ব্যাপক জ্ঞান আছে।)
- Extent (এক্সটেন্ট) - পরিধি [Noun] To what extent do you agree with me? [To-what-কোন extent-পরিধি পর্যন্ত do-তুমি you-তুমি agree-একমত with-me-আমার সাথে] (তুমি আমার সাথে কোন পরিধি পর্যন্ত একমত?)
- External (এক্সটার্নাল) - বাহ্যিক [Adjective] We should not judge people by their external appearance. [We-আমাদের should-উচিত নয় not-না judge-বিচার করা people-মানুষকে by-their-তাদের external-বাহ্যিক appearance-চেহারা দিয়ে] (আমাদের মানুষকে তাদের বাহ্যিক চেহারা দিয়ে বিচার করা উচিত নয়।)
- Extra (এক্সট্রা) - অতিরিক্ত [Adjective] I need some extra time. [I-আমার need-দরকার some-কিছু extra-অতিরিক্ত time-সময়] (আমার কিছু অতিরিক্ত সময় দরকার।)
- Extraordinary (এক্সট্রাঅর্ডিনারি) - অসাধারণ [Adjective] He is an extraordinary person. [He-তিনি is-হন an-একজন extraordinary-অসাধারণ person-ব্যক্তি] (তিনি একজন অসাধারণ ব্যক্তি।)
- Extreme (এক্সট্রিম) - চরম [Adjective] He lives in extreme poverty. [He-সে lives-বসবাস করে in-extreme-চরম poverty-দারিদ্র্যে] (সে চরম দারিদ্র্যে বসবাস করে।)
- Eye (আই) - চোখ [Noun] I have two eyes. [I-আমার have-আছে two-দুটি eyes-চোখ] (আমার দুটি চোখ আছে।)
- Face (ফেস) - মুখ [Noun] She has a beautiful face. [She-তার has-আছে a-একটি beautiful-সুন্দর face-মুখ] (তার একটি সুন্দর মুখ আছে।)
- Fact (ফ্যাক্ট) - ঘটনা [Noun] It is a fact that the sun rises in the east. [It-এটা is-হয় a-একটি fact-ঘটনা that-যে the-সূর্য sun-সূর্য rises-ওঠে in-the-পূর্বে east-পূর্ব] (এটা একটি ঘটনা যে সূর্য পূর্বে ওঠে।)
- Factory (ফ্যাক্টরি) - কারখানা [Noun] He works in a factory. [He-সে works-কাজ করে in-a-একটি factory-কারখানায়] (সে একটি কারখানায় কাজ করে।)
- Fail (ফেইল) - ব্যর্থ হওয়া [Verb] He failed the exam. [He-সে failed-ব্যর্থ হয়েছে the-পরীক্ষায় exam-পরীক্ষা] (সে পরীক্ষায় ব্যর্থ হয়েছে।)
- Fair (ফেয়ার) - ন্যায্য [Adjective] The decision was fair. [The-সিদ্ধান্তটি decision-সিদ্ধান্ত was-ছিল fair-ন্যায্য] (সিদ্ধান্তটি ন্যায্য ছিল।)
- Fall (ফল) - পড়া [Verb] The leaves fall from the trees in autumn. [The-পাতাগুলো leaves-পাতা fall-পড়ে from-the-গাছ থেকে trees-গাছ in-autumn-শরৎকালে] (শরৎকালে গাছ থেকে পাতা পড়ে।)
- Family (ফ্যামিলি) - পরিবার [Noun] I love my family. [I-আমি love-ভালোবাসি my-আমার family-পরিবার] (আমি আমার পরিবারকে ভালোবাসি।)
- Famous (ফেমাস) - বিখ্যাত [Adjective] He is a famous actor. [He-তিনি is-হন a-একজন famous-বিখ্যাত actor-অভিনেতা] (তিনি একজন বিখ্যাত অভিনেতা।)
- Fan (ফ্যান) - পাখা [Noun] The fan is on. [The-পাখাটি fan-পাখা is-চালু on-চালু] (পাখাটি চালু আছে।)
- Far (ফার) - দূরে [Adverb] The station is not far from here. [The-স্টেশনটি station-স্টেশন is-নয় not-নয় far-দূরে from-here-এখান থেকে] (স্টেশনটি এখান থেকে দূরে নয়।)
- Farm (ফার্ম) - খামার [Noun] He has a large farm. [He-তার has-আছে a-একটি large-বড় farm-খামার] (তার একটি বড় খামার আছে।)
- Farmer (ফার্মার) - কৃষক [Noun] The farmer is working in the field. [The-কৃষক farmer-কৃষক is-কাজ করছে working-কাজ করছে in-the-মাঠে field-মাঠ] (কৃষক মাঠে কাজ করছে।)
- Fast (ফাস্ট) - দ্রুত [Adjective] He is a fast runner. [He-সে is-হয় a-একজন fast-দ্রুত runner-দৌড়বিদ] (সে একজন দ্রুত দৌড়বিদ।)
- Fat (ফ্যাট) - মোটা [Adjective] The cat is fat. [The-বিড়ালটি cat-বিড়াল is-হয় fat-মোটা] (বিড়ালটি মোটা।)
- Father (ফাদার) - বাবা [Noun] My father is a doctor. [My-আমার father-বাবা is-হন a-একজন doctor-ডাক্তার] (আমার বাবা একজন ডাক্তার।)
- Fault (ফল্ট) - দোষ [Noun] It is not my fault. [It-এটা is-নয় not-নয় my-আমার fault-দোষ] (এটা আমার দোষ নয়।)
- Fear (ফিয়ার) - ভয় [Noun] He has a fear of heights. [He-তার has-আছে a-একটি fear-ভয় of-এর heights-উচ্চতার] (তার উচ্চতার ভয় আছে।)
- Feather (ফেদার) - পালক [Noun] The bird has beautiful feathers. [The-পাখিটির bird-পাখি has-আছে beautiful-সুন্দর feathers-পালক] (পাখিটির সুন্দর পালক আছে।)
- Feature (ফিচার) - বৈশিষ্ট্য [Noun] This car has many new features. [This-এই car-গাড়িটির has-আছে many-অনেক new-নতুন features-বৈশিষ্ট্য] (এই গাড়িটির অনেক নতুন বৈশিষ্ট্য আছে।)
- February (ফেব্রুয়ারি) - ফেব্রুয়ারি [Noun] February is the second month of the year. [February-ফেব্রুয়ারি is-হয় the-দ্বিতীয় second-দ্বিতীয় month-মাস of-এর the-বছরের year-বছর] (ফেব্রুয়ারি বছরের দ্বিতীয় মাস।)
- Fee (ফি) - ফি [Noun] I have to pay the school fees. [I-আমাকে have-করতে হবে to-দিতে pay-দিতে the-স্কুলের school-স্কুল fees-ফি] (আমাকে স্কুলের ফি দিতে হবে।)
- Feed (ফিড) - খাওয়ানো [Verb] I have to feed my cat. [I-আমাকে have-করতে হবে to-খাওয়াতে feed-খাওয়াতে my-আমার cat-বিড়ালকে] (আমাকে আমার বিড়ালকে খাওয়াতে হবে।)
- Feel (ফিল) - অনুভব করা [Verb] I feel happy today. [I-আমি feel-অনুভব করছি happy-খুশি today-আজ] (আমি আজ খুশি অনুভব করছি।)
- Feeling (ফিলিং) - অনুভূতি [Noun] I have a strange feeling. [I-আমার have-আছে a-একটি strange-অদ্ভুত feeling-অনুভূতি] (আমার একটি অদ্ভুত অনুভূতি আছে।)
- Female (ফিমেল) - মহিলা [Noun] She is a female doctor. [She-তিনি is-হন a-একজন female-মহিলা doctor-ডাক্তার] (তিনি একজন মহিলা ডাক্তার।)
- Fence (ফেন্স) - বেড়া [Noun] There is a fence around the garden. [There-সেখানে is-আছে a-একটি fence-বেড়া around-the-বাগানের চারপাশে garden-বাগান] (বাগানের চারপাশে একটি বেড়া আছে।)
- Festival (ফেস্টিভ্যাল) - উৎসব [Noun] Eid is a big festival. [Eid-ঈদ is-হয় a-একটি big-বড় festival-উৎসব] (ঈদ একটি বড় উৎসব।)
- Fetch (ফেচ) - নিয়ে আসা [Verb] Please fetch me a glass of water. [Please-দয়া করে fetch-নিয়ে আসুন me-আমাকে a-একটি glass-গ্লাস of-এর water-জল] (দয়া করে আমাকে এক গ্লাস জল নিয়ে আসুন।)
- Fever (ফিভার) - জ্বর [Noun] I have a fever. [I-আমার have-আছে a-একটি fever-জ্বর] (আমার জ্বর হয়েছে।)
- Few (ফিউ) - কয়েকটি [Determiner] I have a few friends. [I-আমার have-আছে a-কয়েকটি few-কয়েকটি friends-বন্ধু] (আমার কয়েকটি বন্ধু আছে।)
- Field (ফিল্ড) - মাঠ [Noun] The children are playing in the field. [The-শিশুরা children-শিশু are-খেলছে playing-খেলছে in-the-মাঠে field-মাঠ] (শিশুরা মাঠে খেলছে।)
- Fifteen (ফিফটিন) - পনেরো [Number] I have fifteen books. [I-আমার have-আছে fifteen-পনেরোটি books-বই] (আমার পনেরোটি বই আছে।)
- Fifth (ফিফথ) - পঞ্চম [Ordinal] He was the fifth person in the line. [He-সে was-ছিল the-পঞ্চম fifth-পঞ্চম person-ব্যক্তি in-the-লাইনে line-লাইন] (সে লাইনে পঞ্চম ব্যক্তি ছিল।)
- Fifty (ফিফটি) - পঞ্চাশ [Number] I have fifty dollars. [I-আমার have-আছে fifty-পঞ্চাশ dollars-ডলার] (আমার পঞ্চাশ ডলার আছে।)
- Fight (ফাইট) - লড়াই [Noun] There was a fight between the two boys. [There-সেখানে was-ছিল a-একটি fight-লড়াই between-the-দুটি two-দুটি boys-ছেলের মধ্যে] (দুটি ছেলের মধ্যে একটি লড়াই হয়েছিল।)
- Figure (ফিগার) - চিত্র [Noun] I can't see the figure clearly. [I-আমি can't-পারছি না see-দেখতে the-চিত্রটি figure-চিত্র clearly-পরিষ্কারভাবে] (আমি চিত্রটি পরিষ্কারভাবে দেখতে পারছি না।)
- File (ফাইল) - ফাইল [Noun] I have to submit the file tomorrow. [I-আমাকে have-করতে হবে to-জমা দিতে submit-জমা দিতে the-ফাইলটি file-ফাইল tomorrow-আগামীকাল] (আমাকে আগামীকাল ফাইলটি জমা দিতে হবে।)
- Fill (ফিল) - পূরণ করা [Verb] Please fill this form. [Please-দয়া করে fill-পূরণ করুন this-এই form-ফর্মটি] (দয়া করে এই ফর্মটি পূরণ করুন।)
- Film (ফিল্ম) - চলচ্চিত্র [Noun] I like to watch movies. [I-আমি like-পছন্দ করি to-দেখতে watch-দেখতে movies-চলচ্চিত্র] (আমি চলচ্চিত্র দেখতে পছন্দ করি।)
- Final (ফাইনাল) - চূড়ান্ত [Adjective] This is the final decision. [This-এটা is-হয় the-চূড়ান্ত final-চূড়ান্ত decision-সিদ্ধান্ত] (এটা চূড়ান্ত সিদ্ধান্ত।)
- Finally (ফাইনালি) - অবশেষে [Adverb] Finally, he arrived. [Finally-অবশেষে, he-সে arrived-পৌঁছাল] (অবশেষে, সে পৌঁছাল।)
- Finance (ফাইন্যান্স) - অর্থ [Noun] I am studying finance. [I-আমি am-পড়ছি studying-পড়ছি finance-অর্থ] (আমি অর্থ বিষয়ে পড়ছি।)
- Financial (ফাইন্যান্সিয়াল) - আর্থিক [Adjective] The company is in a good financial position. [The-কোম্পানি company-কোম্পানি is-আছে in-a-একটি good-ভালো financial-আর্থিক position-অবস্থানে] (কোম্পানি একটি ভালো আর্থিক অবস্থানে আছে।)
- Find (ফাইন্ড) - খুঁজে পাওয়া [Verb] I can't find my keys. [I-আমি can't-পারছি না find-খুঁজে পেতে my-আমার keys-চাবিগুলো] (আমি আমার চাবিগুলো খুঁজে পাচ্ছি না।)
- Fine (ফাইন) - ভালো [Adjective] I am fine, thank you. [I-আমি am-ভালো আছি fine-ভালো, thank-ধন্যবাদ you-তোমাকে] (আমি ভালো আছি, ধন্যবাদ।)
- Finger (ফিঙ্গার) - আঙুল [Noun] I have ten fingers. [I-আমার have-আছে ten-দশটি fingers-আঙুল] (আমার দশটি আঙুল আছে।)
- Finish (ফিনিশ) - শেষ করা [Verb] I have to finish my work. [I-আমাকে have-করতে হবে to-শেষ করতে finish-শেষ করতে my-আমার work-কাজ] (আমাকে আমার কাজ শেষ করতে হবে।)
- Fire (ফায়ার) - আগুন [Noun] The house is on fire. [The-বাড়িটি house-বাড়ি is-আগুনে জ্বলছে on-fire-আগুন] (বাড়িটি আগুনে জ্বলছে।)
- Firm (ফার্ম) - দৃঢ় [Adjective] He has a firm belief in God. [He-তার has-আছে a-একটি firm-দৃঢ় belief-বিশ্বাস in-God-ঈশ্বরের প্রতি] (তার ঈশ্বরের প্রতি একটি দৃঢ় বিশ্বাস আছে।)
- First (ফার্স্ট) - প্রথম [Ordinal] He was the first person to arrive. [He-সে was-ছিল the-প্রথম first-প্রথম person-ব্যক্তি to-পৌঁছাতে arrive-পৌঁছাতে] (সে প্রথম ব্যক্তি ছিল যে পৌঁছায়।)
- Fish (ফিশ) - মাছ [Noun] I like to eat fish. [I-আমি like-পছন্দ করি to-খেতে eat-খেতে fish-মাছ] (আমি মাছ খেতে পছন্দ করি।)
- Fit (ফিট) - উপযুক্ত [Adjective] This dress does not fit me. [This-এই dress-পোশাকটি does-না not-না fit-উপযুক্ত me-আমার জন্য] (এই পোশাকটি আমার জন্য উপযুক্ত নয়।)
- Five (ফাইভ) - পাঁচ [Number] I have five pencils. [I-আমার have-আছে five-পাঁচটি pencils-পেন্সিল] (আমার পাঁচটি পেন্সিল আছে।)
- Fix (ফিক্স) - ঠিক করা [Verb] I have to fix my car. [I-আমাকে have-করতে হবে to-ঠিক করতে fix-ঠিক করতে my-আমার car-গাড়িটি] (আমাকে আমার গাড়িটি ঠিক করতে হবে।)
- Flag (ফ্ল্যাগ) - পতাকা [Noun] The flag is flying high. [The-পতাকাটি flag-পতাকা is-উড়ছে flying-উড়ছে high-উঁচুতে] (পতাকাটি উঁচুতে উড়ছে।)
- Flame (ফ্লেম) - শিখা [Noun] The candle flame is flickering. [The-মোমবাতির the candle-মোমবাতি flame-শিখা is-কাঁপছে flickering-কাঁপছে] (মোমবাতির শিখা কাঁপছে।)
- Flash (ফ্ল্যাশ) - ঝলক [Noun] I saw a flash of lightning. [I-আমি saw-দেখলাম a-একটি flash-ঝলক of-এর lightning-বিদ্যুতের] (আমি বিদ্যুতের একটি ঝলক দেখলাম।)
- Flat (ফ্ল্যাট) - সমতল [Adjective] The ground is flat. [The-মাটি ground-মাটি is-হয় flat-সমতল] (মাটি সমতল।)
- Flavor (ফ্লেভার) - স্বাদ [Noun] This ice cream has a nice flavor. [This-এই ice-আইস cream-ক্রিমটির has-আছে a-একটি nice-সুন্দর flavor-স্বাদ] (এই আইসক্রিমটির একটি সুন্দর স্বাদ আছে।)
- Flee (ফ্লি) - পালানো [Verb] The thief tried to flee. [The-চোরটি thief-চোর tried-চেষ্টা করেছিল to-পালাতে flee-পালাতে] (চোরটি পালাতে চেষ্টা করেছিল।)
- Flesh (ফ্লেশ) - মাংস [Noun] The lion eats flesh. [The-সিংহ lion-সিংহ eats-খায় flesh-মাংস] (সিংহ মাংস খায়।)
- Flight (ফ্লাইট) - উড়ান [Noun] The flight was delayed. [The-উড়ান flight-উড়ান was-দেরি হয়েছিল delayed-দেরি] (উড়ানটি দেরি হয়েছিল।)
- Float (ফ্লোট) - ভাসা [Verb] The boat is floating on the water. [The-নৌকাটি boat-নৌকা is-ভাসছে floating-ভাসছে on-the-জলে water-জল] (নৌকাটি জলে ভাসছে।)
- Flood (ফ্লাড) - বন্যা [Noun] The village was affected by the flood. [The-গ্রামটি village-গ্রাম was-ক্ষতিগ্রস্ত হয়েছিল affected-ক্ষতিগ্রস্ত by-the-বন্যায় flood-বন্যা] (গ্রামটি বন্যায় ক্ষতিগ্রস্ত হয়েছিল।)
- Floor (ফ্লোর) - মেঝে [Noun] The cat is sleeping on the floor. [The-বিড়ালটি cat-বিড়াল is-ঘুমাচ্ছে sleeping-ঘুমাচ্ছে on-the-মেঝেতে floor-মেঝে] (বিড়ালটি মেঝেতে ঘুমাচ্ছে।)
- Flour (ফ্লাওয়ার) - ময়দা [Noun] I need some flour to make bread. [I-আমার need-দরকার some-কিছু flour-ময়দা to-বানাতে make-বানাতে bread-রুটি] (আমার রুটি বানাতে কিছু ময়দা দরকার।)
- Flow (ফ্লো) - প্রবাহ [Noun] The flow of the river is very strong. [The-প্রবাহ flow-প্রবাহ of-এর the-নদীটির river-নদী is-হয় very-খুব strong-শক্তিশালী] (নদীটির প্রবাহ খুব শক্তিশালী।)
- Flower (ফ্লাওয়ার) - ফুল [Noun] The rose is a beautiful flower. [The-গোলাপ rose-গোলাপ is-হয় a-একটি beautiful-সুন্দর flower-ফুল] (গোলাপ একটি সুন্দর ফুল।)
- Fly (ফ্লাই) - উড়া [Verb] The bird is flying in the sky. [The-পাখিটি bird-পাখি is-উড়ছে flying-উড়ছে in-the-আকাশে sky-আকাশ] (পাখিটি আকাশে উড়ছে।)
- Focus (ফোকাস) - মনোযোগ [Noun] I need to focus on my studies. [I-আমার need-দরকার to-মনোযোগ দিতে focus-মনোযোগ দিতে on-my-আমার studies-পড়াশোনায়] (আমার পড়াশোনায় মনোযোগ দিতে হবে।)
- Fog (ফগ) - কুয়াশা [Noun] There is a thick fog outside. [There-সেখানে is-আছে a-একটি thick-ঘন fog-কুয়াশা outside-বাইরে] (বাইরে একটি ঘন কুয়াশা আছে।)
- Fold (ফোল্ড) - ভাঁজ করা [Verb] Please fold the clothes. [Please-দয়া করে fold-ভাঁজ করুন the-পোশাকগুলো clothes-পোশাক] (দয়া করে পোশাকগুলো ভাঁজ করুন।)
- Folk (ফোক) - লোক [Noun] I like to listen to folk music. [I-আমি like-পছন্দ করি to-শুনতে listen-শুনতে to-folk-লোক music-সংগীত] (আমি লোকসংগীত শুনতে পছন্দ করি।)
- Follow (ফলো) - অনুসরণ করা [Verb] Please follow the instructions. [Please-দয়া করে follow-অনুসরণ করুন the-নির্দেশাবলী instructions-নির্দেশাবলী] (দয়া করে নির্দেশাবলী অনুসরণ করুন।)
- Food (ফুড) - খাবার [Noun] I am hungry, I need some food. [I-আমি am-ক্ষুধার্ত hungry-ক্ষুধার্ত, I-আমার need-দরকার some-কিছু food-খাবার] (আমি ক্ষুধার্ত, আমার কিছু খাবার দরকার।)
- Fool (ফুল) - বোকা [Noun] He is a fool. [He-সে is-হয় a-একজন fool-বোকা] (সে একজন বোকা।)
- Foot (ফুট) - পা [Noun] I have two feet. [I-আমার have-আছে two-দুটি feet-পা] (আমার দুটি পা আছে।)
- Football (ফুটবল) - ফুটবল [Noun] I like to play football. [I-আমি like-পছন্দ করি to-খেলতে play-খেলতে football-ফুটবল] (আমি ফুটবল খেলতে পছন্দ করি।)
- For (ফর) - জন্য [Preposition] This gift is for you. [This-এই gift-উপহারটি is-হয় for-জন্য you-তোমার] (এই উপহারটি তোমার জন্য।)
- Force (ফোর্স) - বল [Noun] The police used force to control the crowd. [The-পুলিশ police-পুলিশ used-ব্যবহার করেছে force-বল to-নিয়ন্ত্রণ করতে control-নিয়ন্ত্রণ করতে the-ভিড় crowd-ভিড়] (পুলিশ ভিড় নিয়ন্ত্রণ করতে বল ব্যবহার করেছে।)
- Foreign (ফরেন) - বিদেশী [Adjective] He is a foreign tourist. [He-তিনি is-হন a-একজন foreign-বিদেশী tourist-পর্যটক] (তিনি একজন বিদেশী পর্যটক।)
- Forest (ফরেস্ট) - বন [Noun] The tiger lives in the forest. [The-বাঘ tiger-বাঘ lives-থাকে in-the-বনে forest-বন] (বাঘ বনে থাকে।)
- Forget (ফরগেট) - ভুলে যাওয়া [Verb] I always forget his name. [I-আমি always-সবসময় forget-ভুলে যাই his-তার name-নাম] (আমি সবসময় তার নাম ভুলে যাই।)
- Forgive (ফরগিভ) - ক্ষমা করা [Verb] Please forgive me. [Please-দয়া করে forgive-ক্ষমা করুন me-আমাকে] (দয়া করে আমাকে ক্ষমা করুন।)
- Fork (ফর্ক) - কাঁটাচামচ [Noun] I need a fork to eat the noodles. [I-আমার need-দরকার a-একটি fork-কাঁটাচামচ to-খেতে eat-খেতে the-নুডলস noodles-নুডলস] (আমার নুডলস খেতে একটি কাঁটাচামচ দরকার।)
- Form (ফর্ম) - ফর্ম [Noun] Please fill out this form. [Please-দয়া করে fill-পূরণ করুন out-বাইরে this-এই form-ফর্মটি] (দয়া করে এই ফর্মটি পূরণ করুন।)
- Formal (ফর্মাল) - আনুষ্ঠানিক [Adjective] This is a formal meeting. [This-এটা is-হয় a-একটি formal-আনুষ্ঠানিক meeting-সভা] (এটা একটি আনুষ্ঠানিক সভা।)
- Former (ফর্মার) - প্রাক্তন [Adjective] He is a former president. [He-তিনি is-হন a-একজন former-প্রাক্তন president-রাষ্ট্রপতি] (তিনি একজন প্রাক্তন রাষ্ট্রপতি।)
- Formula (ফর্মুলা) - সূত্র [Noun] I don't know the formula. [I-আমি don't-জানি না know-জানি the-সূত্রটি formula-সূত্র] (আমি সূত্রটি জানি না।)
- Fortune (ফরচুন) - ভাগ্য [Noun] He has a good fortune. [He-তার has-আছে a-একটি good-ভালো fortune-ভাগ্য] (তার একটি ভালো ভাগ্য আছে।)
- Forty (ফরটি) - চল্লিশ [Number] I have forty dollars. [I-আমার have-আছে forty-চল্লিশ dollars-ডলার] (আমার চল্লিশ ডলার আছে।)
- Forward (ফরওয়ার্ড) - সামনে [Adverb] Please move forward. [Please-দয়া করে move-সরুন forward-সামনে] (দয়া করে সামনে সরুন।)
- Found (ফাউন্ড) - পাওয়া [Verb] I found my lost keys. [I-আমি found-পেয়েছি my-আমার lost-হারানো keys-চাবিগুলো] (আমি আমার হারানো চাবিগুলো পেয়েছি।)
- Foundation (ফাউন্ডেশন) - ভিত্তি [Noun] The foundation of the building is very strong. [The-ভিত্তি foundation-ভিত্তি of-এর the-ভবনটির building-ভবন is-হয় very-খুব strong-শক্তিশালী] (ভবনটির ভিত্তি খুব শক্তিশালী।)
- Four (ফোর) - চার [Number] I have four pencils. [I-আমার have-আছে four-চারটি pencils-পেন্সিল] (আমার চারটি পেন্সিল আছে।)
- Fourth (ফোর্থ) - চতুর্থ [Ordinal] He was the fourth person in the line. [He-সে was-ছিল the-চতুর্থ fourth-চতুর্থ person-ব্যক্তি in-the-লাইনে line-লাইন] (সে লাইনে চতুর্থ ব্যক্তি ছিল।)
- Fox (ফক্স) - শিয়াল [Noun] The fox is a clever animal. [The-শিয়াল fox-শিয়াল is-হয় a-একটি clever-চালাক animal-পশু] (শিয়াল একটি চালাক পশু।)
- Frame (ফ্রেম) - ফ্রেম [Noun] The picture is in a beautiful frame. [The-ছবিটি picture-ছবি is-আছে in-a-একটি beautiful-সুন্দর frame-ফ্রেমে] (ছবিটি একটি সুন্দর ফ্রেমে আছে।)
- Free (ফ্রি) - বিনামূল্যে [Adjective] The admission is free. [The-প্রবেশ admission-প্রবেশ is-হয় free-বিনামূল্যে] (প্রবেশ বিনামূল্যে।)
- Freedom (ফ্রিডম) - স্বাধীনতা [Noun] We want freedom. [We-আমরা want-চাই freedom-স্বাধীনতা] (আমরা স্বাধীনতা চাই।)
- Freeze (ফ্রিজ) - জমে যাওয়া [Verb] The water will freeze at 0 degrees Celsius. [The-জল water-জল will-জমে যাবে freeze-জমে যাবে at-0-শূন্য degrees-ডিগ্রি Celsius-সেলসিয়াসে] (জল শূন্য ডিগ্রি সেলসিয়াসে জমে যাবে।)
- Fresh (ফ্রেশ) - তাজা [Adjective] I like to eat fresh fruits. [I-আমি like-পছন্দ করি to-খেতে eat-খেতে fresh-তাজা fruits-ফল] (আমি তাজা ফল খেতে পছন্দ করি।)
- Friday (ফ্রাইডে) - শুক্রবার [Noun] Friday is the last day of the week. [Friday-শুক্রবার is-হয় the-শেষ last-শেষ day-দিন of-এর the-সপ্তাহের week-সপ্তাহ] (শুক্রবার সপ্তাহের শেষ দিন।)
- Friend (ফ্রেন্ড) - বন্ধু [Noun] He is my best friend. [He-সে is-হয় my-আমার best-সেরা friend-বন্ধু] (সে আমার সেরা বন্ধু।)
- Friendly (ফ্রেন্ডলি) - বন্ধুত্বপূর্ণ [Adjective] He is a friendly person. [He-সে is-হয় a-একজন friendly-বন্ধুত্বপূর্ণ person-ব্যক্তি] (সে একজন বন্ধুত্বপূর্ণ ব্যক্তি।)
- Friendship (ফ্রেন্ডশিপ) - বন্ধুত্ব [Noun] We have a strong friendship. [We-আমাদের have-আছে a-একটি strong-দৃঢ় friendship-বন্ধুত্ব] (আমাদের একটি দৃঢ় বন্ধুত্ব আছে।)
- Frog (ফ্রগ) - ব্যাঙ [Noun] The frog is jumping. [The-ব্যাঙ frog-ব্যাঙ is-লাফাচ্ছে jumping-লাফাচ্ছে] (ব্যাঙ লাফাচ্ছে।)
- From (ফ্রম) - থেকে [Preposition] I am from Bangladesh. [I-আমি am-এসেছি from-থেকে Bangladesh-বাংলাদেশ] (আমি বাংলাদেশ থেকে এসেছি।)
- Front (ফ্রন্ট) - সামনে [Noun] The car is in front of the house. [The-গাড়িটি car-গাড়ি is-আছে in-front-সামনে of-এর the-বাড়িটির house-বাড়ি] (গাড়িটি বাড়িটির সামনে আছে।)
- Fruit (ফ্রুট) - ফল [Noun] I like to eat fruits. [I-আমি like-পছন্দ করি to-খেতে eat-খেতে fruits-ফল] (আমি ফল খেতে পছন্দ করি।)
- Fuel (ফুয়েল) - জ্বালানি [Noun] The car needs fuel. [The-গাড়িটির car-গাড়ি needs-দরকার fuel-জ্বালানি] (গাড়িটির জ্বালানি দরকার।)
- Full (ফুল) - পূর্ণ [Adjective] The glass is full of water. [The-গ্লাসটি glass-গ্লাস is-পূর্ণ full-পূর্ণ of-দিয়ে water-জল] (গ্লাসটি জল দিয়ে পূর্ণ।)
- Fun (ফান) - মজা [Noun] We had a lot of fun at the party. [We-আমরা had-করেছিলাম a-অনেক lot-অনেক of-এর fun-মজা at-the-পার্টিতে party-পার্টি] (আমরা পার্টিতে অনেক মজা করেছিলাম।)
- Function (ফাংশন) - অনুষ্ঠান [Noun] I am going to a family function. [I-আমি am-যাচ্ছি going-যাচ্ছি to-a-একটি family-পারিবারিক function-অনুষ্ঠানে] (আমি একটি পারিবারিক অনুষ্ঠানে যাচ্ছি।)
- Fund (ফান্ড) - তহবিল [Noun] We need to raise funds for the new project. [We-আমাদের need-দরকার to-সংগ্রহ করতে raise-সংগ্রহ করতে funds-তহবিল for-the-নতুন new-নতুন project-প্রকল্পের জন্য] (আমাদের নতুন প্রকল্পের জন্য তহবিল সংগ্রহ করতে হবে।)
- Funeral (ফিউনারেল) - অন্ত্যেষ্টিক্রিয়া [Noun] I have to attend a funeral. [I-আমাকে have-করতে হবে to-অংশগ্রহণ করতে attend-অংশগ্রহণ করতে a-একটি funeral-অন্ত্যেষ্টিক্রিয়ায়] (আমাকে একটি অন্ত্যেষ্টিক্রিয়ায় অংশগ্রহণ করতে হবে।)
- Funny (ফানি) - মজার [Adjective] The movie was very funny. [The-চলচ্চিত্রটি movie-চলচ্চিত্র was-ছিল very-খুব funny-মজার] (চলচ্চিত্রটি খুব মজার ছিল।)
- Furniture (ফার্নিচার) - আসবাবপত্র [Noun] We need to buy some new furniture. [We-আমাদের need-দরকার to-কিনতে buy-কিনতে some-কিছু new-নতুন furniture-আসবাবপত্র] (আমাদের কিছু নতুন আসবাবপত্র কিনতে হবে।)
- Further (ফার্দার) - আরও [Adverb] I need further information. [I-আমার need-দরকার further-আরও information-তথ্য] (আমার আরও তথ্য দরকার।)
- Future (ফিউচার) - ভবিষ্যৎ [Noun] I am worried about my future. [I-আমি am-উদ্বিগ্ন worried-উদ্বিগ্ন about-my-আমার future-ভবিষ্যৎ নিয়ে] (আমি আমার ভবিষ্যৎ নিয়ে উদ্বিগ্ন।)
- Mango (ম্যাংগো) - আম [Noun] The mango is sweet. [The-টি mango-আম is-হয় sweet-মিষ্টি] (আমটি মিষ্টি।)
- Moon (মুন) - চাঁদ [Noun] The moon is bright. [The-টি moon-চাঁদ is-হয় bright-উজ্জ্বল] (চাঁদটি উজ্জ্বল।)
- Mother (মাদার) - মা [Noun] My mother loves me. [My-আমার mother-মা loves-ভালোবাসে me-আমাকে] (আমার মা আমাকে ভালোবাসে।)
- Mountain (মাউন্টেন) - পর্বত [Noun] The mountain is high. [The-টি mountain-পর্বত is-হয় high-উচ্চ] (পর্বতটি উচ্চ।)
- Mouse (মাউস) - ইঁদুর [Noun] The mouse is small. [The-টি mouse-ইঁদুর is-হয় small-ছোট] (ইঁদুরটি ছোট।)
- Nose (নোজ) - নাক [Noun] I have one nose. [I-আমার have-আছে one-একটি nose-নাক] (আমার একটি নাক আছে।)
- Nest (নেস্ট) - পাখির বাসা [Noun] The bird is in the nest. [The-টি bird-পাখি is-আছে in-the-বাসায় nest-বাসা] (পাখিটি বাসায় আছে।)
- Night (নাইট) - রাত [Noun] The stars shine at night. [The-তারারা stars-তারা shine-জ্বলে at-রাতে night-রাত] (তারারা রাতে জ্বলে।)
- Nail (নেইল) - পেরেক [Noun] The nail is sharp. [The-টি nail-পেরেক is-হয় sharp-ধারালো] (পেরেকটি ধারালো।)
- Neck (নেক) - ঘাড় [Noun] The giraffe has a long neck. [The-জিরাফের giraffe-জিরাফ has-আছে a-একটি long-লম্বা neck-ঘাড়] (জিরাফের একটি লম্বা ঘাড় আছে।)
- Orange (অরেঞ্জ) - কমলা [Noun] The orange is round. [The-কমলাটি orange-কমলা is-হয় round-গোল] (কমলাটি গোল।)
- Owl (আউল) - পেঁচা [Noun] The owl can see at night. [The-পেঁচা owl-পেঁচা can-পারে see-দেখতে at-রাতে night-রাত] (পেঁচা রাতে দেখতে পারে।)
- Ocean (ওশান) - মহাসাগর [Noun] The ocean is vast. [The-মহাসাগর ocean-মহাসাগর is-হয় vast-বিশাল] (মহাসাগর বিশাল।)
- Oil (অয়েল) - তেল [Noun] I need some oil. [I-আমার need-দরকার some-কিছু oil-তেল] (আমার কিছু তেল দরকার।)
- Oven (ওভেন) - চুলা [Noun] The cake is in the oven. [The-কেকটি cake-কেক is-আছে in-the-চুলায় oven-চুলা] (কেকটি চুলায় আছে।)
- Pen (পেন) - কলম [Noun] I write with a pen. [I-আমি write-লিখি with-দিয়ে a-একটি pen-কলম] (আমি একটি কলম দিয়ে লিখি।)
- Pencil (পেন্সিল) - পেন্সিল [Noun] I draw with a pencil. [I-আমি draw-আঁকি with-দিয়ে a-একটি pencil-পেন্সিল] (আমি একটি পেন্সিল দিয়ে আঁকি।)
- Pig (পিগ) - শূকর [Noun] The pig is fat. [The-শূকরটি pig-শূকর is-হয় fat-মোটা] (শূকরটি মোটা।)
- Pin (পিন) - পিন [Noun] The pin is sharp. [The-পিনটি pin-পিন is-হয় sharp-ধারালো] (পিনটি ধারালো।)
- Pot (পট) - পাত্র [Noun] The pot is on the stove. [The-পাত্রটি pot-পাত্র is-আছে on-the-চুলায় stove-চুলা] (পাত্রটি চুলায় আছে।)
- Queen (কুইন) - রানী [Noun] The queen is beautiful. [The-রানী queen-রানী is-হয় beautiful-সুন্দর] (রানী সুন্দর।)
- Quilt (কুইল্ট) - লেপ [Noun] The quilt is warm. [The-লেপটি quilt-লেপ is-হয় warm-উষ্ণ] (লেপটি উষ্ণ।)
- Quiet (কোয়ায়েট) - শান্ত [Adjective] The library is a quiet place. [The-লাইব্রেরি library-লাইব্রেরি is-হয় a-একটি quiet-শান্ত place-জায়গা] (লাইব্রেরি একটি শান্ত জায়গা।)
- Question (কোয়েশ্চেন) - প্রশ্ন [Noun] I have a question. [I-আমার have-আছে a-একটি question-প্রশ্ন] (আমার একটি প্রশ্ন আছে।)
- Quick (কুইক) - দ্রুত [Adjective] He is a quick runner. [He-সে is-হয় a-একজন quick-দ্রুত runner-দৌড়বিদ] (সে একজন দ্রুত দৌড়বিদ।)
- Rabbit (র‍্যাবিট) - খরগোশ [Noun] The rabbit is cute. [The-খরগোশটি rabbit-খরগোশ is-হয় cute-সুন্দর] (খরগোশটি সুন্দর।)
- Rain (রেইন) - বৃষ্টি [Noun] The rain is falling. [The-বৃষ্টি rain-বৃষ্টি is-পড়ছে falling-পড়ছে] (বৃষ্টি পড়ছে।)
- Rat (র‍্যাট) - ইঁদুর [Noun] The cat is chasing the rat. [The-বিড়ালটি cat-বিড়াল is-তাড়া করছে chasing-তাড়া করছে the-ইঁদুরটিকে rat-ইঁদুর] (বিড়ালটি ইঁদুরটিকে তাড়া করছে।)
- Ring (রিং) - আংটি [Noun] She is wearing a ring. [She-সে is-পরে আছে wearing-পরে আছে a-একটি ring-আংটি] (সে একটি আংটি পরে আছে।)
- River (রিভার) - নদী [Noun] The river is long. [The-নদীটি river-নদী is-হয় long-লম্বা] (নদীটি লম্বা।)